,GEO_ID,NAME,tot_poverty,pov_18_64,pov_65_up,pov_150,pov_18_up
1,0500000US01003,"Baldwin County, Alabama",208868,122247,41946,33254,164193
2,0500000US01015,"Calhoun County, Alabama",111724,67411,19454,30355,86865
3,0500000US01043,"Cullman County, Alabama",81055,49216,14448,17756,63664
4,0500000US01049,"DeKalb County, Alabama",70727,42111,11518,25601,53629
5,0500000US01051,"Elmore County, Alabama",76708,46815,11805,12042,58620
6,0500000US01055,"Etowah County, Alabama",101679,60858,18642,27438,79500
7,0500000US01069,"Houston County, Alabama",103411,61691,17858,29816,79549
8,0500000US01073,"Jefferson County, Alabama",644575,398168,98040,169942,496208
9,0500000US01077,"Lauderdale County, Alabama",90424,54439,17792,19069,72231
10,0500000US01081,"Lee County, Alabama",155472,102787,18537,45150,121324
11,0500000US01083,"Limestone County, Alabama",91340,56075,14090,19537,70165
12,0500000US01089,"Madison County, Alabama",351404,220926,52558,73488,273484
13,0500000US01095,"Marshall County, Alabama",94437,55690,15309,31018,70999
14,0500000US01097,"Mobile County, Alabama",407816,246868,64019,125471,310887
15,0500000US01101,"Montgomery County, Alabama",219295,134721,32115,68525,166836
16,0500000US01103,"Morgan County, Alabama",116298,69752,20219,31320,89971
17,0500000US01115,"St. Clair County, Alabama",86113,51177,14407,22081,65584
18,0500000US01117,"Shelby County, Alabama",210793,128692,31714,28087,160406
19,0500000US01121,"Talladega County, Alabama",76498,45786,13425,24628,59211
20,0500000US01125,"Tuscaloosa County, Alabama",197923,128433,26306,47237,154739
21,0500000US01127,"Walker County, Alabama",62798,37514,11706,16713,49220
22,0500000US02020,"Anchorage Municipality, Alaska",285980,186586,29914,43157,216500
23,0500000US02090,"Fairbanks North Star Borough, Alaska",95018,61959,9495,14489,71454
24,0500000US02170,"Matanuska-Susitna Borough, Alaska",104733,64184,12075,19678,76259
25,0500000US04001,"Apache County, Arizona",70470,40158,10699,34424,50857
26,0500000US04003,"Cochise County, Arizona",116856,63743,26559,30641,90302
27,0500000US04005,"Coconino County, Arizona",128286,82675,16520,36791,99195
28,0500000US04013,"Maricopa County, Arizona",4247306,2589441,632798,941859,3222239
29,0500000US04015,"Mohave County, Arizona",203442,106862,61178,57824,168040
30,0500000US04017,"Navajo County, Arizona",105351,58729,18183,39932,76912
31,0500000US04019,"Pima County, Arizona",992023,586603,193950,273331,780553
32,0500000US04021,"Pinal County, Arizona",405133,221936,85116,95655,307052
33,0500000US04025,"Yavapai County, Arizona",223575,116630,69751,53820,186381
34,0500000US04027,"Yuma County, Arizona",202343,113170,37314,61761,150484
35,0500000US05007,"Benton County, Arkansas",263413,158979,33983,42356,192962
36,0500000US05031,"Craighead County, Arkansas",102588,62702,14649,24768,77351
37,0500000US05045,"Faulkner County, Arkansas",119147,75488,15056,30094,90544
38,0500000US05051,"Garland County, Arkansas",96727,54387,22955,25855,77342
39,0500000US05069,"Jefferson County, Arkansas",62476,35887,11343,22945,47230
40,0500000US05085,"Lonoke County, Arkansas",72329,44043,9259,15041,53302
41,0500000US05119,"Pulaski County, Arkansas",386953,238981,57179,96985,296160
42,0500000US05125,"Saline County, Arkansas",118174,70570,19822,18180,90392
43,0500000US05131,"Sebastian County, Arkansas",126299,77263,18583,39095,95846
44,0500000US05143,"Washington County, Arkansas",223854,141873,25398,61358,167271
45,0500000US05145,"White County, Arkansas",75194,44675,12215,20121,56890
46,0500000US06001,"Alameda County, California",1636780,1075381,219776,238749,1295157
47,0500000US06007,"Butte County, California",222834,137335,40356,64880,177691
48,0500000US06013,"Contra Costa County, California",1138850,706569,173127,177747,879696
49,0500000US06017,"El Dorado County, California",186880,111973,38284,24351,150257
50,0500000US06019,"Fresno County, California",972580,579542,115749,333484,695291
51,0500000US06023,"Humboldt County, California",133795,85265,22795,42072,108060
52,0500000US06025,"Imperial County, California",172839,97494,23379,56196,120873
53,0500000US06029,"Kern County, California",860951,514366,93285,303584,607651
54,0500000US06031,"Kings County, California",137266,81901,14639,40768,96540
55,0500000US06033,"Lake County, California",62921,36411,14029,19460,50440
56,0500000US06037,"Los Angeles County, California",10015695,6500672,1317958,2491280,7818630
57,0500000US06039,"Madera County, California",147949,85909,20815,44556,106724
58,0500000US06041,"Marin County, California",254666,146855,55929,34534,202784
59,0500000US06045,"Mendocino County, California",86625,49061,18860,21954,67921
60,0500000US06047,"Merced County, California",266782,158522,29616,100210,188138
61,0500000US06053,"Monterey County, California",421645,250320,56876,100227,307196
62,0500000US06055,"Napa County, California",137998,83821,24978,14544,108799
63,0500000US06057,"Nevada County, California",98227,55675,26039,19169,81714
64,0500000US06059,"Orange County, California",3154479,2008175,451088,593579,2459263
65,0500000US06061,"Placer County, California",383228,224477,73121,48920,297598
66,0500000US06065,"Riverside County, California",2385745,1441699,337625,531704,1779324
67,0500000US06067,"Sacramento County, California",1509927,946339,206170,358123,1152509
68,0500000US06071,"San Bernardino County, California",2093857,1295583,236541,559724,1532124
69,0500000US06073,"San Diego County, California",3256674,2091523,446508,621424,2538031
70,0500000US06075,"San Francisco County, California",870556,620439,133665,136670,754104
71,0500000US06077,"San Joaquin County, California",730261,440097,90556,187466,530653
72,0500000US06079,"San Luis Obispo County, California",266572,162638,54336,47155,216974
73,0500000US06081,"San Mateo County, California",764859,486596,120238,82890,606834
74,0500000US06083,"Santa Barbara County, California",428449,266265,65199,97227,331464
75,0500000US06085,"Santa Clara County, California",1908123,1231733,251029,236158,1482762
76,0500000US06087,"Santa Cruz County, California",264550,169451,42456,54677,211907
77,0500000US06089,"Shasta County, California",177609,103474,35975,48132,139449
78,0500000US06095,"Solano County, California",434864,271578,65680,73301,337258
79,0500000US06097,"Sonoma County, California",497812,306896,93399,73934,400295
80,0500000US06099,"Stanislaus County, California",543542,327545,69453,138394,396998
81,0500000US06101,"Sutter County, California",95258,56549,14184,22997,70733
82,0500000US06107,"Tulare County, California",457905,267628,49672,186785,317300
83,0500000US06111,"Ventura County, California",842331,520204,126517,147835,646721
84,0500000US06113,"Yolo County, California",211305,140020,25956,57497,165976
85,0500000US06115,"Yuba County, California",75108,46461,8504,15794,54965
86,0500000US08001,"Adams County, Colorado",498083,313977,50411,96290,364388
87,0500000US08005,"Arapahoe County, Colorado",635583,406369,79197,81063,485566
88,0500000US08013,"Boulder County, Colorado",310539,205194,43139,55941,248333
89,0500000US08014,"Broomfield County, Colorado",68050,43273,8707,4882,51980
90,0500000US08031,"Denver County, Colorado",692739,473480,80680,137735,554160
91,0500000US08035,"Douglas County, Colorado",334328,207474,38180,19434,245654
92,0500000US08041,"El Paso County, Colorado",679623,428001,85754,122411,513755
93,0500000US08059,"Jefferson County, Colorado",565168,361570,90228,70305,451798
94,0500000US08069,"Larimer County, Colorado",333649,215626,51253,61808,266879
95,0500000US08077,"Mesa County, Colorado",147030,87579,28271,38065,115850
96,0500000US08101,"Pueblo County, Colorado",162192,96397,28810,46364,125207
97,0500000US08123,"Weld County, Colorado",296521,182453,35319,49213,217772
98,0500000US09001,"Fairfield County, Connecticut",932655,577123,142377,133798,719500
99,0500000US09003,"Hartford County, Connecticut",873965,542458,145625,157402,688083
100,0500000US09005,"Litchfield County, Connecticut",179596,111845,35633,19941,147478
101,0500000US09007,"Middlesex County, Connecticut",158081,97940,30763,18330,128703
102,0500000US09009,"New Haven County, Connecticut",834225,521517,139486,144800,661003
103,0500000US09011,"New London County, Connecticut",256641,159138,45662,36826,204800
104,0500000US09013,"Tolland County, Connecticut",136260,88610,21807,19469,110417
105,0500000US09015,"Windham County, Connecticut",111161,70966,18133,20056,89099
106,0500000US10001,"Kent County, Delaware",171408,103129,28250,42741,131379
107,0500000US10003,"New Castle County, Delaware",541646,341871,82060,110098,423931
108,0500000US10005,"Sussex County, Delaware",221893,121630,58821,45067,180451
109,0500000US11001,"District of Columbia, District of Columbia",660642,455807,81484,149265,537291
110,0500000US12001,"Alachua County, Florida",254070,170942,35712,78466,206654
111,0500000US12005,"Bay County, Florida",180707,111605,30085,43070,141690
112,0500000US12009,"Brevard County, Florida",582362,341079,134439,119181,475518
113,0500000US12011,"Broward County, Florida",1917954,1202422,310140,437574,1512562
114,0500000US12015,"Charlotte County, Florida",178129,85440,70642,32411,156082
115,0500000US12017,"Citrus County, Florida",142931,69869,52069,33365,121938
116,0500000US12019,"Clay County, Florida",210394,127923,32666,40478,160589
117,0500000US12021,"Collier County, Florida",368662,188690,116845,73871,305535
118,0500000US12023,"Columbia County, Florida",65127,37077,12842,18379,49919
119,0500000US12031,"Duval County, Florida",917415,584363,125100,223272,709463
120,0500000US12033,"Escambia County, Florida",296410,182793,49409,77255,232202
121,0500000US12035,"Flagler County, Florida",109314,58765,32353,28574,91118
122,0500000US12053,"Hernando County, Florida",184469,98346,51049,43892,149395
123,0500000US12055,"Highlands County, Florida",101552,48233,35146,36055,83379
124,0500000US12057,"Hillsborough County, Florida",1386942,876960,194126,348492,1071086
125,0500000US12061,"Indian River County, Florida",153120,79374,48584,31564,127958
126,0500000US12069,"Lake County, Florida",341574,185005,90791,83041,275796
127,0500000US12071,"Lee County, Florida",730723,395063,204703,154026,599766
128,0500000US12073,"Leon County, Florida",277973,188256,36501,75479,224757
129,0500000US12081,"Manatee County, Florida",381406,207750,103120,76291,310870
130,0500000US12083,"Marion County, Florida",344056,178949,100041,98015,278990
131,0500000US12085,"Martin County, Florida",157053,83157,47579,31584,130736
132,0500000US12086,"Miami-Dade County, Florida",2714753,1730906,430931,775540,2161837
133,0500000US12087,"Monroe County, Florida",75598,47514,16609,15843,64123
134,0500000US12089,"Nassau County, Florida",81369,48375,17596,10561,65971
135,0500000US12091,"Okaloosa County, Florida",196544,120709,31546,36069,152255
136,0500000US12095,"Orange County, Florida",1316802,863425,155020,349889,1018445
137,0500000US12097,"Osceola County, Florida",349896,218636,44914,94959,263550
138,0500000US12099,"Palm Beach County, Florida",1451150,829951,341631,296894,1171582
139,0500000US12101,"Pasco County, Florida",517491,295329,116735,116619,412064
140,0500000US12103,"Pinellas County, Florida",956815,568328,230092,205682,798420
141,0500000US12105,"Polk County, Florida",672674,386095,136346,182441,522441
142,0500000US12107,"Putnam County, Florida",71683,40530,16217,28942,56747
143,0500000US12109,"St. Johns County, Florida",241231,141488,46911,36397,188399
144,0500000US12111,"St. Lucie County, Florida",310703,174647,73651,74090,248298
145,0500000US12113,"Santa Rosa County, Florida",167876,103522,26598,32265,130120
146,0500000US12115,"Sarasota County, Florida",413427,205007,149254,68001,354261
147,0500000US12117,"Seminole County, Florida",457684,292259,69261,83520,361520
148,0500000US12119,"Sumter County, Florida",116064,37474,70491,17970,107965
149,0500000US12127,"Volusia County, Florida",527753,306381,127261,128475,433642
150,0500000US12131,"Walton County, Florida",66079,39275,13450,17489,52725
151,0500000US13013,"Barrow County, Georgia",78676,49036,8987,18093,58023
152,0500000US13015,"Bartow County, Georgia",103558,63977,14517,25246,78494
153,0500000US13021,"Bibb County, Georgia",146882,87478,22204,54384,109682
154,0500000US13031,"Bulloch County, Georgia",66962,43805,8099,25820,51904
155,0500000US13045,"Carroll County, Georgia",114291,71884,14636,33437,86520
156,0500000US13047,"Catoosa County, Georgia",65924,39742,11027,11517,50769
157,0500000US13051,"Chatham County, Georgia",278384,175607,40686,70425,216293
158,0500000US13057,"Cherokee County, Georgia",245782,152645,31775,31253,184420
159,0500000US13059,"Clarke County, Georgia",116592,81875,13046,44288,94921
160,0500000US13063,"Clayton County, Georgia",276748,175462,25178,84296,200640
161,0500000US13067,"Cobb County, Georgia",745708,477392,88341,127413,565733
162,0500000US13073,"Columbia County, Georgia",149734,93188,19227,14364,112415
163,0500000US13077,"Coweta County, Georgia",142286,87877,19262,28264,107139
164,0500000US13089,"DeKalb County, Georgia",740346,478068,88844,184442,566912
165,0500000US13095,"Dougherty County, Georgia",85626,51360,13173,33909,64533
166,0500000US13097,"Douglas County, Georgia",142146,88521,16542,30295,105063
167,0500000US13113,"Fayette County, Georgia",110935,65752,19929,12819,85681
168,0500000US13115,"Floyd County, Georgia",93757,55888,15434,27519,71322
169,0500000US13117,"Forsyth County, Georgia",227047,137575,26242,18831,163817
170,0500000US13121,"Fulton County, Georgia",1009230,664188,115442,223889,779630
171,0500000US13127,"Glynn County, Georgia",84068,49261,16054,19576,65315
172,0500000US13135,"Gwinnett County, Georgia",912053,578186,87463,182237,665649
173,0500000US13139,"Hall County, Georgia",197523,118486,28418,42621,146904
174,0500000US13151,"Henry County, Georgia",224371,141011,24849,42149,165860
175,0500000US13153,"Houston County, Georgia",151311,94083,18381,35470,112464
176,0500000US13157,"Jackson County, Georgia",66868,40305,9972,12056,50277
177,0500000US13185,"Lowndes County, Georgia",111730,70925,12998,41058,83923
178,0500000US13215,"Muscogee County, Georgia",184955,113350,24562,60663,137912
179,0500000US13217,"Newton County, Georgia",106733,64471,14011,21178,78482
180,0500000US13223,"Paulding County, Georgia",158590,99489,16165,27735,115654
181,0500000US13245,"Richmond County, Georgia",192151,119962,26499,67037,146461
182,0500000US13247,"Rockdale County, Georgia",89493,54812,12176,23721,66988
183,0500000US13255,"Spalding County, Georgia",64412,37263,11315,23141,48578
184,0500000US13285,"Troup County, Georgia",67990,40949,10101,24329,51050
185,0500000US13295,"Walker County, Georgia",67547,39842,12632,17708,52474
186,0500000US13297,"Walton County, Georgia",90698,54066,13927,22669,67993
187,0500000US13313,"Whitfield County, Georgia",102936,62299,13568,38407,75867
188,0500000US15001,"Hawaii County, Hawaii",197136,114409,39787,43565,154196
189,0500000US15003,"Honolulu County, Hawaii",955728,583702,167222,127927,750924
190,0500000US15007,"Kauai County, Hawaii",71328,41512,13874,14728,55386
191,0500000US15009,"Maui County, Hawaii",164290,100332,28544,21335,128876
192,0500000US16001,"Ada County, Idaho",446820,275767,61963,75593,337730
193,0500000US16005,"Bannock County, Idaho",83345,49921,11530,19935,61451
194,0500000US16019,"Bonneville County, Idaho",113401,63741,14544,22688,78285
195,0500000US16027,"Canyon County, Idaho",213847,123635,28583,72449,152218
196,0500000US16055,"Kootenai County, Idaho",155658,91661,28346,26431,120007
197,0500000US16083,"Twin Falls County, Idaho",83568,47912,12279,22303,60191
198,0500000US17001,"Adams County, Illinois",64753,37616,12557,14434,50173
199,0500000US17019,"Champaign County, Illinois",193968,129858,25298,53533,155156
200,0500000US17031,"Cook County, Illinois",5127661,3270439,720693,1208006,3991132
201,0500000US17037,"DeKalb County, Illinois",100692,66030,12137,22148,78167
202,0500000US17043,"DuPage County, Illinois",916449,570527,135482,102367,706009
203,0500000US17089,"Kane County, Illinois",528169,323848,68255,79617,392103
204,0500000US17091,"Kankakee County, Illinois",105115,63422,16832,21672,80254
205,0500000US17093,"Kendall County, Illinois",125445,76404,13181,13804,89585
206,0500000US17097,"Lake County, Illinois",686699,421497,94031,97426,515528
207,0500000US17099,"LaSalle County, Illinois",106633,64505,18776,24982,83281
208,0500000US17111,"McHenry County, Illinois",306434,191980,41668,30479,233648
209,0500000US17113,"McLean County, Illinois",164387,106500,21568,36571,128068
210,0500000US17115,"Macon County, Illinois",101890,59530,19683,22318,79213
211,0500000US17119,"Madison County, Illinois",259401,158966,43668,59510,202634
212,0500000US17143,"Peoria County, Illinois",178185,105522,29468,43795,134990
213,0500000US17161,"Rock Island County, Illinois",139880,81753,26098,30176,107851
214,0500000US17163,"St. Clair County, Illinois",258669,158405,38969,61644,197374
215,0500000US17167,"Sangamon County, Illinois",192634,116825,32385,43930,149210
216,0500000US17179,"Tazewell County, Illinois",130582,77687,23296,20587,100983
217,0500000US17183,"Vermilion County, Illinois",74765,42017,14617,22886,56634
218,0500000US17197,"Will County, Illinois",682425,424667,85191,82597,509858
219,0500000US17199,"Williamson County, Illinois",64652,38654,12060,14768,50714
220,0500000US17201,"Winnebago County, Illinois",279900,167571,47153,63901,214724
221,0500000US18003,"Allen County, Indiana",366986,221102,51014,83206,272116
222,0500000US18005,"Bartholomew County, Indiana",81062,48986,12778,15506,61764
223,0500000US18011,"Boone County, Indiana",64630,39722,8337,5283,48059
224,0500000US18019,"Clark County, Indiana",114945,71315,17502,24533,88817
225,0500000US18035,"Delaware County, Indiana",107474,69535,18208,32455,87743
226,0500000US18039,"Elkhart County, Indiana",201482,117534,27999,38400,145533
227,0500000US18043,"Floyd County, Indiana",75282,46193,11288,15412,57481
228,0500000US18053,"Grant County, Indiana",60943,34911,12337,18597,47248
229,0500000US18057,"Hamilton County, Indiana",321756,195991,37302,21210,233293
230,0500000US18059,"Hancock County, Indiana",73985,44769,11158,8527,55927
231,0500000US18063,"Hendricks County, Indiana",160736,98778,21288,17569,120066
232,0500000US18067,"Howard County, Indiana",80913,47540,15347,18111,62887
233,0500000US18081,"Johnson County, Indiana",150827,92328,21447,21608,113775
234,0500000US18085,"Kosciusko County, Indiana",77496,46543,12371,15160,58914
235,0500000US18089,"Lake County, Indiana",479109,289911,76367,110407,366278
236,0500000US18091,"LaPorte County, Indiana",102133,60136,18621,27272,78757
237,0500000US18095,"Madison County, Indiana",123716,73964,22144,35566,96108
238,0500000US18097,"Marion County, Indiana",932111,588487,113442,265882,701929
239,0500000US18105,"Monroe County, Indiana",131331,90918,17972,41194,108890
240,0500000US18109,"Morgan County, Indiana",68529,42082,10975,11777,53057
241,0500000US18127,"Porter County, Indiana",163861,101088,25540,30195,126628
242,0500000US18141,"St. Joseph County, Indiana",258461,154297,40979,60771,195276
243,0500000US18157,"Tippecanoe County, Indiana",173856,114865,20346,45759,135211
244,0500000US18163,"Vanderburgh County, Indiana",174176,108382,28476,46245,136858
245,0500000US18167,"Vigo County, Indiana",98524,61117,16171,30292,77288
246,0500000US18177,"Wayne County, Indiana",63367,37923,11232,17722,49155
247,0500000US19013,"Black Hawk County, Iowa",127270,78880,20168,31905,99048
248,0500000US19049,"Dallas County, Iowa",86808,52635,9699,5982,62334
249,0500000US19061,"Dubuque County, Iowa",92879,55619,15798,15401,71417
250,0500000US19103,"Johnson County, Iowa",141265,94907,16576,32771,111483
251,0500000US19113,"Linn County, Iowa",218936,133605,33510,35279,167115
252,0500000US19153,"Polk County, Iowa",473217,295045,59238,81270,354283
253,0500000US19155,"Pottawattamie County, Iowa",91034,53893,15604,14964,69497
254,0500000US19163,"Scott County, Iowa",168975,102194,26127,30779,128321
255,0500000US19169,"Story County, Iowa",85818,59086,10805,21499,69891
256,0500000US19193,"Woodbury County, Iowa",99671,58535,14760,22765,73295
257,0500000US20015,"Butler County, Kansas",63369,37392,9629,11605,47021
258,0500000US20045,"Douglas County, Kansas",112478,76621,13925,31116,90546
259,0500000US20091,"Johnson County, Kansas",586180,361229,80066,56110,441295
260,0500000US20103,"Leavenworth County, Kansas",75298,44804,10652,6393,55456
261,0500000US20161,"Riley County, Kansas",64402,45545,6596,19269,52141
262,0500000US20173,"Sedgwick County, Kansas",505464,305549,70312,121963,375861
263,0500000US20177,"Shawnee County, Kansas",173702,102589,29956,32992,132545
264,0500000US20209,"Wyandotte County, Kansas",163896,98940,19029,52146,117969
265,0500000US21015,"Boone County, Kentucky",129391,79426,16471,15407,95897
266,0500000US21029,"Bullitt County, Kentucky",79481,49825,12217,12850,62042
267,0500000US21037,"Campbell County, Kentucky",88675,56353,13452,14882,69805
268,0500000US21047,"Christian County, Kentucky",64332,37128,8135,20021,45263
269,0500000US21059,"Daviess County, Kentucky",96886,57318,15697,26335,73015
270,0500000US21067,"Fayette County, Kentucky",308523,202354,40115,75064,242469
271,0500000US21093,"Hardin County, Kentucky",105221,64853,14115,24280,78968
272,0500000US21111,"Jefferson County, Kentucky",755194,468538,117329,162642,585867
273,0500000US21117,"Kenton County, Kentucky",163046,101578,22713,30674,124291
274,0500000US21145,"McCracken County, Kentucky",62909,37917,11844,15327,49761
275,0500000US21151,"Madison County, Kentucky",84812,54297,11862,23183,66159
276,0500000US21185,"Oldham County, Kentucky",62841,37147,7633,4151,44780
277,0500000US21227,"Warren County, Kentucky",120701,76707,15547,32964,92254
278,0500000US22005,"Ascension Parish, Louisiana",121895,75646,13382,24929,89028
279,0500000US22015,"Bossier Parish, Louisiana",124325,75706,16358,36365,92064
280,0500000US22017,"Caddo Parish, Louisiana",241396,144283,38976,96541,183259
281,0500000US22019,"Calcasieu Parish, Louisiana",199105,120722,28299,48601,149021
282,0500000US22033,"East Baton Rouge Parish, Louisiana",437794,277838,59054,114217,336892
283,0500000US22045,"Iberia Parish, Louisiana",71018,42249,9882,25373,52131
284,0500000US22051,"Jefferson Parish, Louisiana",435457,268297,71713,117650,340010
285,0500000US22055,"Lafayette Parish, Louisiana",237467,150552,29209,69870,179761
286,0500000US22057,"Lafourche Parish, Louisiana",96222,59578,14092,24075,73670
287,0500000US22063,"Livingston Parish, Louisiana",137262,83472,17999,28706,101471
288,0500000US22071,"Orleans Parish, Louisiana",380032,247584,54284,143867,301868
289,0500000US22073,"Ouachita Parish, Louisiana",148717,89023,21369,57283,110392
290,0500000US22079,"Rapides Parish, Louisiana",127584,75005,20266,43070,95271
291,0500000US22097,"St. Landry Parish, Louisiana",81528,47087,12622,31948,59709
292,0500000US22103,"St. Tammany Parish, Louisiana",254083,151700,40893,44742,192593
293,0500000US22105,"Tangipahoa Parish, Louisiana",127789,78721,17894,42945,96615
294,0500000US22109,"Terrebonne Parish, Louisiana",110249,66827,15277,37707,82104
295,0500000US23001,"Androscoggin County, Maine",104662,63384,18201,26668,81585
296,0500000US23003,"Aroostook County, Maine",65540,38528,14945,18864,53473
297,0500000US23005,"Cumberland County, Maine",284274,179306,51179,41548,230485
298,0500000US23011,"Kennebec County, Maine",118172,72696,22302,27126,94998
299,0500000US23019,"Penobscot County, Maine",144978,91690,26785,36633,118475
300,0500000US23031,"York County, Maine",201504,123860,39610,25083,163470
301,0500000US24001,"Allegany County, Maryland",63586,37975,13181,18311,51156
302,0500000US24003,"Anne Arundel County, Maryland",559136,352688,79937,58806,432625
303,0500000US24005,"Baltimore County, Maryland",812046,501175,133767,114031,634942
304,0500000US24009,"Calvert County, Maryland",90752,56473,13087,10479,69560
305,0500000US24013,"Carroll County, Maryland",164219,101829,26161,13256,127990
306,0500000US24015,"Cecil County, Maryland",101695,63377,15128,17339,78505
307,0500000US24017,"Charles County, Maryland",157186,99606,19217,18052,118823
308,0500000US24021,"Frederick County, Maryland",247113,154386,34468,27718,188854
309,0500000US24025,"Harford County, Maryland",249860,154698,39184,29969,193882
310,0500000US24027,"Howard County, Maryland",318333,198508,42656,32344,241164
311,0500000US24031,"Montgomery County, Maryland",1050441,650972,154890,131184,805862
312,0500000US24033,"Prince George's County, Maryland",893578,577723,114710,134710,692433
313,0500000US24037,"St. Mary's County, Maryland",109187,68192,13472,13693,81664
314,0500000US24043,"Washington County, Maryland",142287,85553,23984,29262,109537
315,0500000US24045,"Wicomico County, Maryland",99172,61834,14740,21898,76574
316,0500000US24510,"Baltimore city, Maryland",588922,384944,79992,185700,464936
317,0500000US25001,"Barnstable County, Massachusetts",210631,116289,62077,26886,178366
318,0500000US25003,"Berkshire County, Massachusetts",119910,71741,27517,20457,99258
319,0500000US25005,"Bristol County, Massachusetts",545156,342196,89963,104669,432159
320,0500000US25009,"Essex County, Massachusetts",768545,475662,126620,132563,602282
321,0500000US25011,"Franklin County, Massachusetts",69675,42424,14634,12500,57058
322,0500000US25013,"Hampden County, Massachusetts",455207,280237,75132,126523,355369
323,0500000US25015,"Hampshire County, Massachusetts",139218,89707,26114,20716,115821
324,0500000US25017,"Middlesex County, Massachusetts",1545950,998500,232651,190662,1231151
325,0500000US25021,"Norfolk County, Massachusetts",682292,423104,112280,71807,535384
326,0500000US25023,"Plymouth County, Massachusetts",502976,307073,86769,58199,393842
327,0500000US25025,"Suffolk County, Massachusetts",755810,533090,90521,194773,623611
328,0500000US25027,"Worcester County, Massachusetts",798786,504876,121539,131501,626415
329,0500000US26005,"Allegan County, Michigan",115361,69348,17868,18285,87216
330,0500000US26017,"Bay County, Michigan",102743,62004,20107,25595,82111
331,0500000US26021,"Berrien County, Michigan",150427,88507,29273,40115,117780
332,0500000US26025,"Calhoun County, Michigan",130776,78519,22056,37400,100575
333,0500000US26037,"Clinton County, Michigan",77735,47890,12692,11994,60582
334,0500000US26045,"Eaton County, Michigan",107332,65599,18953,15187,84552
335,0500000US26049,"Genesee County, Michigan",402439,243279,67786,114842,311065
336,0500000US26055,"Grand Traverse County, Michigan",90560,55447,17200,15863,72647
337,0500000US26065,"Ingham County, Michigan",271508,177023,38071,76592,215094
338,0500000US26073,"Isabella County, Michigan",64523,43967,8676,22276,52643
339,0500000US26075,"Jackson County, Michigan",148125,88445,26543,33250,114988
340,0500000US26077,"Kalamazoo County, Michigan",254899,161820,37438,58334,199258
341,0500000US26081,"Kent County, Michigan",636894,399057,83469,118295,482526
342,0500000US26087,"Lapeer County, Michigan",86395,53017,15267,15048,68284
343,0500000US26091,"Lenawee County, Michigan",93207,55941,17043,18078,72984
344,0500000US26093,"Livingston County, Michigan",188160,117076,30553,18939,147629
345,0500000US26099,"Macomb County, Michigan",860170,538046,141837,162285,679883
346,0500000US26103,"Marquette County, Michigan",62911,39664,11528,16028,51192
347,0500000US26111,"Midland County, Michigan",82132,49757,14612,13821,64369
348,0500000US26115,"Monroe County, Michigan",147874,90583,25886,28468,116469
349,0500000US26121,"Muskegon County, Michigan",166573,100333,27268,42780,127601
350,0500000US26125,"Oakland County, Michigan",1239128,774711,201731,161454,976442
351,0500000US26139,"Ottawa County, Michigan",276163,167701,40885,45123,208586
352,0500000US26145,"Saginaw County, Michigan",184951,110942,35096,49010,146038
353,0500000US26147,"St. Clair County, Michigan",157183,95795,28762,32221,124557
354,0500000US26155,"Shiawassee County, Michigan",67430,40977,11944,14998,52921
355,0500000US26159,"Van Buren County, Michigan",74264,44593,12394,22542,56987
356,0500000US26161,"Washtenaw County, Michigan",347382,231997,48509,62331,280506
357,0500000US26163,"Wayne County, Michigan",1730239,1064084,258000,568013,1322084
358,0500000US27003,"Anoka County, Minnesota",347889,218462,46445,36364,264907
359,0500000US27013,"Blue Earth County, Minnesota",63556,42470,8377,16179,50847
360,0500000US27019,"Carver County, Minnesota",101152,62542,11242,7296,73784
361,0500000US27037,"Dakota County, Minnesota",419457,260356,56288,44782,316644
362,0500000US27053,"Hennepin County, Minnesota",1229487,794026,165550,202171,959576
363,0500000US27109,"Olmsted County, Minnesota",153075,93150,22342,21130,115492
364,0500000US27123,"Ramsey County, Minnesota",534438,333574,74621,123597,408195
365,0500000US27131,"Rice County, Minnesota",57416,33654,9982,12025,43636
366,0500000US27137,"St. Louis County, Minnesota",191844,119660,35887,41603,155547
367,0500000US27139,"Scott County, Minnesota",144094,89616,13994,9539,103610
368,0500000US27141,"Sherburne County, Minnesota",92665,57748,10128,6457,67876
369,0500000US27145,"Stearns County, Minnesota",150136,92727,22309,27346,115036
370,0500000US27163,"Washington County, Minnesota",252527,153621,36576,17812,190197
371,0500000US27171,"Wright County, Minnesota",133170,79610,16203,13974,95813
372,0500000US28033,"DeSoto County, Mississippi",177174,108900,22865,22454,131765
373,0500000US28035,"Forrest County, Mississippi",72029,44926,9996,24049,54922
374,0500000US28047,"Harrison County, Mississippi",200322,121828,29286,56260,151114
375,0500000US28049,"Hinds County, Mississippi",229688,140171,32832,69614,173003
376,0500000US28059,"Jackson County, Mississippi",140921,85496,21808,29970,107304
377,0500000US28067,"Jones County, Mississippi",66516,38437,10965,26782,49402
378,0500000US28075,"Lauderdale County, Mississippi",72692,42866,12554,22819,55420
379,0500000US28081,"Lee County, Mississippi",83891,50457,11798,17023,62255
380,0500000US28089,"Madison County, Mississippi",102510,63441,13414,17310,76855
381,0500000US28121,"Rankin County, Mississippi",146803,89989,21570,26389,111559
382,0500000US29019,"Boone County, Missouri",169268,113400,20800,40917,134200
383,0500000US29021,"Buchanan County, Missouri",84687,50681,13976,19436,64657
384,0500000US29031,"Cape Girardeau County, Missouri",74845,46459,12205,19384,58664
385,0500000US29037,"Cass County, Missouri",102209,61264,16465,19865,77729
386,0500000US29043,"Christian County, Missouri",84557,50439,12937,16003,63376
387,0500000US29047,"Clay County, Missouri",239668,148970,33236,31923,182206
388,0500000US29051,"Cole County, Missouri",71952,43736,11707,15460,55443
389,0500000US29071,"Franklin County, Missouri",102164,61351,17108,19316,78459
390,0500000US29077,"Greene County, Missouri",278305,174251,45144,76847,219395
391,0500000US29095,"Jackson County, Missouri",688120,426364,98391,157150,524755
392,0500000US29097,"Jasper County, Missouri",117647,70196,17867,32971,88063
393,0500000US29099,"Jefferson County, Missouri",220863,137944,32088,37862,170032
394,0500000US29165,"Platte County, Missouri",98791,62626,13948,11378,76574
395,0500000US29183,"St. Charles County, Missouri",386269,236730,57105,33786,293835
396,0500000US29187,"St. Francois County, Missouri",59607,35416,10424,19773,45840
397,0500000US29189,"St. Louis County, Missouri",973403,591783,168823,153555,760606
398,0500000US29510,"St. Louis city, Missouri",300850,203397,38333,99418,241730
399,0500000US30013,"Cascade County, Montana",79473,46910,14774,16047,61684
400,0500000US30029,"Flathead County, Montana",98795,59224,18125,18364,77349
401,0500000US30031,"Gallatin County, Montana",104113,69831,12798,17075,82629
402,0500000US30049,"Lewis and Clark County, Montana",66123,39986,11892,11344,51878
403,0500000US30063,"Missoula County, Montana",114893,74935,17481,26750,92416
404,0500000US30111,"Yellowstone County, Montana",154036,93278,25748,29451,119026
405,0500000US31055,"Douglas County, Nebraska",548421,338817,68484,112445,407301
406,0500000US31109,"Lancaster County, Nebraska",301041,188175,41411,60145,229586
407,0500000US31153,"Sarpy County, Nebraska",179428,109960,20282,15631,130242
408,0500000US32003,"Clark County, Nevada",2174635,1355951,314547,491354,1670498
409,0500000US32031,"Washoe County, Nevada",455076,283281,72696,89118,355977
410,0500000US33005,"Cheshire County, New Hampshire",71613,44207,14159,10510,58366
411,0500000US33009,"Grafton County, New Hampshire",82719,51037,17076,16358,68113
412,0500000US33011,"Hillsborough County, New Hampshire",401265,258310,59696,53054,318006
413,0500000US33013,"Merrimack County, New Hampshire",141681,89148,25360,16867,114508
414,0500000US33015,"Rockingham County, New Hampshire",303942,192832,51562,27231,244394
415,0500000US33017,"Strafford County, New Hampshire",119036,77365,18552,20616,95917
416,0500000US34001,"Atlantic County, New Jersey",263996,161824,45458,58470,207282
417,0500000US34003,"Bergen County, New Jersey",937588,582597,155346,104945,737943
418,0500000US34005,"Burlington County, New Jersey",436598,272193,72445,48943,344638
419,0500000US34007,"Camden County, New Jersey",504302,313502,75921,94231,389423
420,0500000US34009,"Cape May County, New Jersey",91274,52345,23146,15729,75491
421,0500000US34011,"Cumberland County, New Jersey",141495,84718,21300,40260,106018
422,0500000US34013,"Essex County, New Jersey",789520,496255,104423,192203,600678
423,0500000US34015,"Gloucester County, New Jersey",287809,180515,44113,30048,224628
424,0500000US34017,"Hudson County, New Jersey",682788,466750,77888,158008,544638
425,0500000US34019,"Hunterdon County, New Jersey",121185,75685,21291,8966,96976
426,0500000US34021,"Mercer County, New Jersey",360177,227097,53735,65423,280832
427,0500000US34023,"Middlesex County, New Jersey",811655,511508,119607,110715,631115
428,0500000US34025,"Monmouth County, New Jersey",619902,384064,103731,72351,487795
429,0500000US34027,"Morris County, New Jersey",492112,305196,80479,38291,385675
430,0500000US34029,"Ocean County, New Jersey",589672,320782,129954,96430,450736
431,0500000US34031,"Passaic County, New Jersey",505116,312679,71197,130956,383876
432,0500000US34033,"Salem County, New Jersey",61570,37301,10899,13795,48200
433,0500000US34035,"Somerset County, New Jersey",331833,209319,49458,26155,258777
434,0500000US34037,"Sussex County, New Jersey",140163,90235,22535,10570,112770
435,0500000US34039,"Union County, New Jersey",557213,350286,76912,95220,427198
436,0500000US34041,"Warren County, New Jersey",105232,66199,17563,12516,83762
437,0500000US35001,"Bernalillo County, New Mexico",668209,416076,105138,161314,521214
438,0500000US35005,"Chaves County, New Mexico",62345,36016,9949,22078,45965
439,0500000US35013,"Doña Ana County, New Mexico",209038,123043,32872,85012,155915
440,0500000US35025,"Lea County, New Mexico",66280,37852,7876,17768,45728
441,0500000US35031,"McKinley County, New Mexico",71792,42570,8335,37945,50905
442,0500000US35035,"Otero County, New Mexico",62357,37233,9891,16713,47124
443,0500000US35043,"Sandoval County, New Mexico",141603,84204,24146,34639,108350
444,0500000US35045,"San Juan County, New Mexico",124556,73562,17840,46300,91402
445,0500000US35049,"Santa Fe County, New Mexico",146265,85450,33853,34757,119303
446,0500000US35061,"Valencia County, New Mexico",74283,43947,12776,24830,56723
447,0500000US36001,"Albany County, New York",293809,189099,48431,53396,237530
448,0500000US36005,"Bronx County, New York",1435378,907269,172396,589001,1079665
449,0500000US36007,"Broome County, New York",183875,111959,34886,47827,146845
450,0500000US36009,"Cattaraugus County, New York",74884,43984,14078,19648,58062
451,0500000US36011,"Cayuga County, New York",73024,44445,13726,15307,58171
452,0500000US36013,"Chautauqua County, New York",123442,73228,24414,36735,97642
453,0500000US36015,"Chemung County, New York",80582,47844,14897,19972,62741
454,0500000US36019,"Clinton County, New York",73088,46471,12528,14867,58999
455,0500000US36027,"Dutchess County, New York",278676,174899,48538,44052,223437
456,0500000US36029,"Erie County, New York",898505,556488,156719,200135,713207
457,0500000US36045,"Jefferson County, New York",107182,66098,14615,28759,80713
458,0500000US36047,"Kings County, New York",2623860,1676688,348698,797512,2025386
459,0500000US36051,"Livingston County, New York",57181,35891,10533,11514,46424
460,0500000US36053,"Madison County, New York",66086,39651,12275,11626,51926
461,0500000US36055,"Monroe County, New York",722190,447892,120301,157283,568193
462,0500000US36059,"Nassau County, New York",1350723,826160,231561,131583,1057721
463,0500000US36061,"New York County, New York",1617953,1121165,260649,386914,1381814
464,0500000US36063,"Niagara County, New York",207464,128151,37744,45332,165895
465,0500000US36065,"Oneida County, New York",218886,131102,40138,55696,171240
466,0500000US36067,"Onondaga County, New York",444950,273193,74368,102219,347561
467,0500000US36069,"Ontario County, New York",106719,63764,20645,18083,84409
468,0500000US36071,"Orange County, New York",371620,225884,50901,65105,276785
469,0500000US36075,"Oswego County, New York",112725,70794,18376,29696,89170
470,0500000US36079,"Putnam County, New York",97818,62744,15817,8063,78561
471,0500000US36081,"Queens County, New York",2332041,1522409,344697,505061,1867106
472,0500000US36083,"Rensselaer County, New York",153614,97407,25904,27641,123311
473,0500000US36085,"Richmond County, New York",473237,296491,73219,84520,369710
474,0500000US36087,"Rockland County, New York",324642,183756,49881,73933,233637
475,0500000US36089,"St. Lawrence County, New York",97914,59305,17532,28307,76837
476,0500000US36091,"Saratoga County, New York",226478,140966,39138,25674,180104
477,0500000US36093,"Schenectady County, New York",151294,93272,25008,27869,118280
478,0500000US36101,"Steuben County, New York",94214,56595,17857,20686,74452
479,0500000US36103,"Suffolk County, New York",1467347,916160,237929,166583,1154089
480,0500000US36105,"Sullivan County, New York",72981,44315,13541,17469,57856
481,0500000US36109,"Tompkins County, New York",91475,63175,13861,23684,77036
482,0500000US36111,"Ulster County, New York",172109,107231,33413,36846,140644
483,0500000US36113,"Warren County, New York",63369,38590,13783,9037,52373
484,0500000US36117,"Wayne County, New York",89785,54273,16115,19862,70388
485,0500000US36119,"Westchester County, New York",956596,585960,157753,144166,743713
486,0500000US37001,"Alamance County, North Carolina",158086,95804,26276,42355,122080
487,0500000US37019,"Brunswick County, North Carolina",129885,69194,39859,24147,109053
488,0500000US37021,"Buncombe County, North Carolina",251125,155601,48250,50534,203851
489,0500000US37023,"Burke County, North Carolina",86303,53049,16782,25447,69831
490,0500000US37025,"Cabarrus County, North Carolina",205183,125732,25999,35557,151731
491,0500000US37027,"Caldwell County, North Carolina",80208,49051,15509,22669,64560
492,0500000US37031,"Carteret County, North Carolina",67285,38956,16259,15221,55215
493,0500000US37035,"Catawba County, North Carolina",155381,93189,27240,32960,120429
494,0500000US37037,"Chatham County, North Carolina",70856,39152,16988,15272,56140
495,0500000US37045,"Cleveland County, North Carolina",95908,56799,17576,31830,74375
496,0500000US37049,"Craven County, North Carolina",97299,56029,18855,24982,74884
497,0500000US37051,"Cumberland County, North Carolina",317441,198045,38208,97541,236253
498,0500000US37057,"Davidson County, North Carolina",163354,98402,28541,44429,126943
499,0500000US37063,"Durham County, North Carolina",298471,196067,37706,77217,233773
500,0500000US37067,"Forsyth County, North Carolina",365657,222153,56886,97332,279039
501,0500000US37069,"Franklin County, North Carolina",64858,39912,10178,17542,50090
502,0500000US37071,"Gaston County, North Carolina",217395,133974,34012,58561,167986
503,0500000US37081,"Guilford County, North Carolina",510079,316486,76387,125732,392873
504,0500000US37085,"Harnett County, North Carolina",129581,78658,15945,34873,94603
505,0500000US37089,"Henderson County, North Carolina",114464,64401,27900,20556,92301
506,0500000US37097,"Iredell County, North Carolina",173963,106276,27422,36340,133698
507,0500000US37101,"Johnston County, North Carolina",194553,119894,25047,49757,144941
508,0500000US37109,"Lincoln County, North Carolina",81511,49792,14331,20433,64123
509,0500000US37119,"Mecklenburg County, North Carolina",1062738,691636,115761,205167,807397
510,0500000US37125,"Moore County, North Carolina",96012,53317,21651,14083,74968
511,0500000US37127,"Nash County, North Carolina",92120,55012,16364,24556,71376
512,0500000US37129,"New Hanover County, North Carolina",220909,140374,38303,56986,178677
513,0500000US37133,"Onslow County, North Carolina",173335,108694,17790,38242,126484
514,0500000US37135,"Orange County, North Carolina",134785,86832,19649,28490,106481
515,0500000US37147,"Pitt County, North Carolina",173030,112608,22410,54893,135018
516,0500000US37151,"Randolph County, North Carolina",141306,86060,23956,39928,110016
517,0500000US37155,"Robeson County, North Carolina",128979,77018,19193,52762,96211
518,0500000US37157,"Rockingham County, North Carolina",89278,53948,17271,22663,71219
519,0500000US37159,"Rowan County, North Carolina",136871,82066,23888,35404,105954
520,0500000US37161,"Rutherford County, North Carolina",65059,37906,13696,16405,51602
521,0500000US37171,"Surry County, North Carolina",71293,42171,13917,21793,56088
522,0500000US37179,"Union County, North Carolina",227990,138927,27370,36928,166297
523,0500000US37183,"Wake County, North Carolina",1052020,676962,117842,153785,794804
524,0500000US37191,"Wayne County, North Carolina",121000,72853,19439,40945,92292
525,0500000US37193,"Wilkes County, North Carolina",67296,40118,13707,23314,53825
526,0500000US37195,"Wilson County, North Carolina",80249,47967,13521,23627,61488
527,0500000US38015,"Burleigh County, North Dakota",92133,55402,14104,13993,69506
528,0500000US38017,"Cass County, North Dakota",173094,114591,19651,24693,134242
529,0500000US38035,"Grand Forks County, North Dakota",65878,44265,7948,18595,52213
530,0500000US38101,"Ward County, North Dakota",66442,42487,8405,10164,50892
531,0500000US39003,"Allen County, Ohio",99727,58782,17250,23319,76032
532,0500000US39007,"Ashtabula County, Ohio",94525,55953,17265,31293,73218
533,0500000US39009,"Athens County, Ohio",56813,39351,8006,21955,47357
534,0500000US39013,"Belmont County, Ohio",63913,38467,12895,8895,51362
535,0500000US39017,"Butler County, Ohio",366685,226943,52200,63459,279143
536,0500000US39023,"Clark County, Ohio",131089,76853,24646,34268,101499
537,0500000US39025,"Clermont County, Ohio",202244,124588,31185,32569,155773
538,0500000US39029,"Columbiana County, Ohio",99420,58856,19517,26438,78373
539,0500000US39035,"Cuyahoga County, Ohio",1222384,752087,213097,327723,965184
540,0500000US39041,"Delaware County, Ohio",196976,118400,25907,15689,144307
541,0500000US39043,"Erie County, Ohio",73220,43222,15405,13693,58627
542,0500000US39045,"Fairfield County, Ohio",151773,91933,23201,22755,115134
543,0500000US39049,"Franklin County, Ohio",1261641,817119,146631,294525,963750
544,0500000US39055,"Geauga County, Ohio",92900,53300,18221,10900,71521
545,0500000US39057,"Greene County, Ohio",157598,97120,26469,26387,123589
546,0500000US39061,"Hamilton County, Ohio",796667,493515,117191,187434,610706
547,0500000US39063,"Hancock County, Ohio",73634,45274,11690,13015,56964
548,0500000US39081,"Jefferson County, Ohio",63843,38201,13191,17160,51392
549,0500000US39085,"Lake County, Ohio",226626,137100,44060,36178,181160
550,0500000US39089,"Licking County, Ohio",169315,102365,27297,28236,129662
551,0500000US39093,"Lorain County, Ohio",297853,177274,52868,60527,230142
552,0500000US39095,"Lucas County, Ohio",419878,257954,65782,111785,323736
553,0500000US39099,"Mahoning County, Ohio",222619,133492,44666,65391,178158
554,0500000US39101,"Marion County, Ohio",59372,35608,10487,17497,46095
555,0500000US39103,"Medina County, Ohio",176795,106782,30053,18123,136835
556,0500000US39109,"Miami County, Ohio",104020,61480,18666,18185,80146
557,0500000US39113,"Montgomery County, Ohio",513667,307742,89983,137239,397725
558,0500000US39119,"Muskingum County, Ohio",84133,50188,14488,20083,64676
559,0500000US39133,"Portage County, Ohio",154382,98807,25652,28546,124459
560,0500000US39139,"Richland County, Ohio",112756,65022,22323,26829,87345
561,0500000US39141,"Ross County, Ohio",70881,43155,11933,17599,55088
562,0500000US39145,"Scioto County, Ohio",72377,43329,13054,23419,56383
563,0500000US39151,"Stark County, Ohio",362654,216447,68377,84592,284824
564,0500000US39153,"Summit County, Ohio",531825,327974,91358,113647,419332
565,0500000US39155,"Trumbull County, Ohio",196477,114923,41229,51185,156152
566,0500000US39157,"Tuscarawas County, Ohio",90633,52735,17481,19576,70216
567,0500000US39165,"Warren County, Ohio",221268,133565,31046,17617,164611
568,0500000US39169,"Wayne County, Ohio",111736,64621,19441,26073,84062
569,0500000US39173,"Wood County, Ohio",123769,79007,18628,24221,97635
570,0500000US40017,"Canadian County, Oklahoma",137842,84386,17222,15692,101608
571,0500000US40027,"Cleveland County, Oklahoma",266928,171757,34899,56138,206656
572,0500000US40031,"Comanche County, Oklahoma",112075,69391,14922,35084,84313
573,0500000US40037,"Creek County, Oklahoma",70696,41986,11661,18555,53647
574,0500000US40101,"Muskogee County, Oklahoma",65394,37888,10831,24286,48719
575,0500000US40109,"Oklahoma County, Oklahoma",773775,470644,102497,208776,573141
576,0500000US40119,"Payne County, Oklahoma",73626,47510,9790,27667,57300
577,0500000US40125,"Pottawatomie County, Oklahoma",68965,40910,11236,16633,52146
578,0500000US40131,"Rogers County, Oklahoma",89488,54593,13848,16784,68441
579,0500000US40143,"Tulsa County, Oklahoma",636045,386945,88373,157031,475318
580,0500000US40145,"Wagoner County, Oklahoma",78076,46795,12312,15170,59107
581,0500000US41003,"Benton County, Oregon",85006,56164,14053,22010,70217
582,0500000US41005,"Clackamas County, Oregon",408663,250368,71440,56231,321808
583,0500000US41017,"Deschutes County, Oregon",186160,112009,35687,31518,147696
584,0500000US41019,"Douglas County, Oregon",108159,61079,26606,27109,87685
585,0500000US41029,"Jackson County, Oregon",215025,124581,46226,51220,170807
586,0500000US41033,"Josephine County, Oregon",85314,47691,21405,26582,69096
587,0500000US41035,"Klamath County, Oregon",65946,37681,14329,22272,52010
588,0500000US41039,"Lane County, Oregon",367554,229296,69867,95687,299163
589,0500000US41043,"Linn County, Oregon",124318,73220,22547,32572,95767
590,0500000US41047,"Marion County, Oregon",332206,198434,50678,88878,249112
591,0500000US41051,"Multnomah County, Oregon",792960,539017,102348,177649,641365
592,0500000US41053,"Polk County, Oregon",81481,48088,14603,22390,62691
593,0500000US41059,"Umatilla County, Oregon",72182,42389,10814,21307,53203
594,0500000US41067,"Washington County, Oregon",582714,372543,75253,80431,447796
595,0500000US41071,"Yamhill County, Oregon",100602,59724,17470,16478,77194
596,0500000US42001,"Adams County, Pennsylvania",98333,58623,19388,13202,78011
597,0500000US42003,"Allegheny County, Pennsylvania",1189264,743788,218489,216275,962277
598,0500000US42005,"Armstrong County, Pennsylvania",64956,38910,13613,17458,52523
599,0500000US42007,"Beaver County, Pennsylvania",163766,96847,34846,31901,131693
600,0500000US42011,"Berks County, Pennsylvania",404958,243598,68871,80315,312469
601,0500000US42013,"Blair County, Pennsylvania",120888,72412,23414,31333,95826
602,0500000US42017,"Bucks County, Pennsylvania",620082,380514,111506,61385,492020
603,0500000US42019,"Butler County, Pennsylvania",181193,110857,33427,25893,144284
604,0500000US42021,"Cambria County, Pennsylvania",126874,73121,28590,30627,101711
605,0500000US42025,"Carbon County, Pennsylvania",62552,38354,12409,13388,50763
606,0500000US42027,"Centre County, Pennsylvania",143641,97661,21741,36294,119402
607,0500000US42029,"Chester County, Pennsylvania",505715,309167,79245,56918,388412
608,0500000US42033,"Clearfield County, Pennsylvania",73688,44383,15333,17878,59716
609,0500000US42037,"Columbia County, Pennsylvania",61415,37895,11817,12513,49712
610,0500000US42039,"Crawford County, Pennsylvania",82330,48167,17018,19014,65185
611,0500000US42041,"Cumberland County, Pennsylvania",236017,142768,43207,29323,185975
612,0500000US42043,"Dauphin County, Pennsylvania",271530,166101,44587,52788,210688
613,0500000US42045,"Delaware County, Pennsylvania",544237,333745,87982,85239,421727
614,0500000US42049,"Erie County, Pennsylvania",261659,158263,45416,65097,203679
615,0500000US42051,"Fayette County, Pennsylvania",127092,76792,25875,39366,102667
616,0500000US42055,"Franklin County, Pennsylvania",151928,89480,28790,27184,118270
617,0500000US42063,"Indiana County, Pennsylvania",79145,48739,15475,21347,64214
618,0500000US42069,"Lackawanna County, Pennsylvania",202842,121803,38991,45932,160794
619,0500000US42071,"Lancaster County, Pennsylvania",531482,313694,90352,91585,404046
620,0500000US42073,"Lawrence County, Pennsylvania",84959,49425,18326,18767,67751
621,0500000US42075,"Lebanon County, Pennsylvania",136189,78870,25872,23955,104742
622,0500000US42077,"Lehigh County, Pennsylvania",357157,218728,56339,76907,275067
623,0500000US42079,"Luzerne County, Pennsylvania",306084,185671,58877,69672,244548
624,0500000US42081,"Lycoming County, Pennsylvania",107389,64437,20147,23410,84584
625,0500000US42085,"Mercer County, Pennsylvania",104618,61745,22228,22102,83973
626,0500000US42089,"Monroe County, Pennsylvania",165651,104923,27633,29211,132556
627,0500000US42091,"Montgomery County, Pennsylvania",803702,491539,136072,72211,627611
628,0500000US42095,"Northampton County, Pennsylvania",292086,177651,54904,49114,232555
629,0500000US42097,"Northumberland County, Pennsylvania",87943,52380,18195,20016,70575
630,0500000US42101,"Philadelphia County, Pennsylvania",1537998,995217,205040,547119,1200257
631,0500000US42107,"Schuylkill County, Pennsylvania",135172,80838,26982,26443,107820
632,0500000US42111,"Somerset County, Pennsylvania",69203,40350,15294,14711,55644
633,0500000US42125,"Washington County, Pennsylvania",202404,122022,40407,34661,162429
634,0500000US42129,"Westmoreland County, Pennsylvania",345761,205313,76203,57000,281516
635,0500000US42133,"York County, Pennsylvania",436295,266158,73062,71671,339220
636,0500000US44003,"Kent County, Rhode Island",162108,102547,29348,21961,131895
637,0500000US44005,"Newport County, Rhode Island",79406,48346,16865,9166,65211
638,0500000US44007,"Providence County, Rhode Island",612095,391140,91246,139881,482386
639,0500000US44009,"Washington County, Rhode Island",119872,75627,23802,16809,99429
640,0500000US45003,"Aiken County, South Carolina",165376,98494,31179,42928,129673
641,0500000US45007,"Anderson County, South Carolina",195617,116332,34779,53446,151111
642,0500000US45013,"Beaufort County, South Carolina",182213,97855,48843,36909,146698
643,0500000US45015,"Berkeley County, South Carolina",213806,131449,30182,44875,161631
644,0500000US45019,"Charleston County, South Carolina",389905,249167,61886,83801,311053
645,0500000US45031,"Darlington County, South Carolina",66116,38831,12113,19402,50944
646,0500000US45035,"Dorchester County, South Carolina",154233,96171,19954,27252,116125
647,0500000US45041,"Florence County, South Carolina",135182,80161,22177,42242,102338
648,0500000US45045,"Greenville County, South Carolina",494415,302268,76318,100770,378586
649,0500000US45047,"Greenwood County, South Carolina",67949,40570,12530,20425,53100
650,0500000US45051,"Horry County, South Carolina",328346,191096,76682,98323,267778
651,0500000US45055,"Kershaw County, South Carolina",64812,38186,11387,14348,49573
652,0500000US45057,"Lancaster County, South Carolina",90137,51723,18958,19314,70681
653,0500000US45059,"Laurens County, South Carolina",64732,38761,11367,23286,50128
654,0500000US45063,"Lexington County, South Carolina",286818,176022,43818,56008,219840
655,0500000US45073,"Oconee County, South Carolina",76291,43881,17506,19972,61387
656,0500000US45075,"Orangeburg County, South Carolina",84908,49624,16348,31394,65972
657,0500000US45077,"Pickens County, South Carolina",116824,73732,19614,31898,93346
658,0500000US45079,"Richland County, South Carolina",381086,244467,49850,102761,294317
659,0500000US45083,"Spartanburg County, South Carolina",298526,181595,47311,75224,228906
660,0500000US45085,"Sumter County, South Carolina",104185,63045,16559,30491,79604
661,0500000US45091,"York County, South Carolina",261990,161157,36752,47175,197909
662,0500000US46099,"Minnehaha County, South Dakota",182525,112592,23925,29955,136517
663,0500000US46103,"Pennington County, South Dakota",107302,64371,18102,20905,82473
664,0500000US47001,"Anderson County, Tennessee",74804,44269,14597,17826,58866
665,0500000US47009,"Blount County, Tennessee",127572,76084,25491,29438,101575
666,0500000US47011,"Bradley County, Tennessee",101716,62437,16693,27507,79130
667,0500000US47037,"Davidson County, Tennessee",669497,446442,79989,155460,526431
668,0500000US47059,"Greene County, Tennessee",66857,39635,13913,21135,53548
669,0500000US47065,"Hamilton County, Tennessee",350662,215429,60736,77518,276165
670,0500000US47093,"Knox County, Tennessee",451896,286099,69023,106959,355122
671,0500000US47113,"Madison County, Tennessee",93956,57042,15466,23874,72508
672,0500000US47119,"Maury County, Tennessee",90993,56118,13374,14122,69492
673,0500000US47125,"Montgomery County, Tennessee",195700,125637,17477,45241,143114
674,0500000US47141,"Putnam County, Tennessee",74154,45726,12225,26704,57951
675,0500000US47147,"Robertson County, Tennessee",68902,42717,9608,15209,52325
676,0500000US47149,"Rutherford County, Tennessee",311903,203807,30782,53753,234589
677,0500000US47155,"Sevier County, Tennessee",96165,58241,18321,25219,76562
678,0500000US47157,"Shelby County, Tennessee",920373,568859,119813,265231,688672
679,0500000US47163,"Sullivan County, Tennessee",154626,91340,33255,43496,124595
680,0500000US47165,"Sumner County, Tennessee",181638,111677,27021,29113,138698
681,0500000US47179,"Washington County, Tennessee",122245,76796,21952,30441,98748
682,0500000US47187,"Williamson County, Tennessee",225593,134498,29162,17061,163660
683,0500000US47189,"Wilson County, Tennessee",135036,81760,20813,19481,102573
684,0500000US48005,"Angelina County, Texas",84479,49490,13705,28445,63195
685,0500000US48021,"Bastrop County, Texas",82145,50331,10018,14033,60349
686,0500000US48027,"Bell County, Texas",336805,205782,35529,80224,241311
687,0500000US48029,"Bexar County, Texas",1923051,1200111,226451,508259,1426562
688,0500000US48037,"Bowie County, Texas",88530,52386,13919,23372,66305
689,0500000US48039,"Brazoria County, Texas",349746,214051,40226,52351,254277
690,0500000US48041,"Brazos County, Texas",206646,142063,18427,75263,160490
691,0500000US48061,"Cameron County, Texas",420863,236119,55091,179038,291210
692,0500000US48085,"Collin County, Texas",965116,609041,102654,107493,711695
693,0500000US48091,"Comal County, Texas",139941,82742,24928,23925,107670
694,0500000US48099,"Coryell County, Texas",61282,37312,6628,14041,43940
695,0500000US48113,"Dallas County, Texas",2588355,1634175,267510,694747,1901685
696,0500000US48121,"Denton County, Texas",823321,534486,80953,95588,615439
697,0500000US48135,"Ector County, Texas",155631,93993,14960,35482,108953
698,0500000US48139,"Ellis County, Texas",170984,103925,21365,26078,125290
699,0500000US48141,"El Paso County, Texas",826172,498375,98076,282280,596451
700,0500000US48157,"Fort Bend County, Texas",758920,467431,80682,111311,548113
701,0500000US48167,"Galveston County, Texas",328362,202162,45083,62607,247245
702,0500000US48181,"Grayson County, Texas",128332,75534,21947,29221,97481
703,0500000US48183,"Gregg County, Texas",119298,69356,18201,38497,87557
704,0500000US48187,"Guadalupe County, Texas",157650,96387,20920,26392,117307
705,0500000US48201,"Harris County, Texas",4603968,2902252,467289,1235426,3369541
706,0500000US48203,"Harrison County, Texas",65043,37551,10386,18697,47937
707,0500000US48209,"Hays County, Texas",207040,135741,21777,45225,157518
708,0500000US48213,"Henderson County, Texas",79273,44706,17640,23807,62346
709,0500000US48215,"Hidalgo County, Texas",849416,475709,90855,381662,566564
710,0500000US48231,"Hunt County, Texas",90842,54150,14556,24127,68706
711,0500000US48245,"Jefferson County, Texas",238358,144344,34284,71045,178628
712,0500000US48251,"Johnson County, Texas",164022,98499,22568,31310,121067
713,0500000US48257,"Kaufman County, Texas",121450,73489,13659,18958,87148
714,0500000US48291,"Liberty County, Texas",75638,45040,9873,20648,54913
715,0500000US48303,"Lubbock County, Texas",292216,185310,35468,89881,220778
716,0500000US48309,"McLennan County, Texas",241376,146454,34165,69820,180619
717,0500000US48329,"Midland County, Texas",163052,100316,16583,25159,116899
718,0500000US48339,"Montgomery County, Texas",567385,345872,71706,95816,417578
719,0500000US48347,"Nacogdoches County, Texas",59820,35387,9262,21524,44649
720,0500000US48355,"Nueces County, Texas",352624,214423,49624,98302,264047
721,0500000US48361,"Orange County, Texas",84120,50504,12553,19525,63057
722,0500000US48367,"Parker County, Texas",131628,78507,20693,14916,99200
723,0500000US48375,"Potter County, Texas",113328,67349,13195,38744,80544
724,0500000US48381,"Randall County, Texas",131838,80632,19531,21832,100163
725,0500000US48397,"Rockwall County, Texas",96094,58821,10948,10500,69769
726,0500000US48409,"San Patricio County, Texas",66498,39483,9484,20573,48967
727,0500000US48423,"Smith County, Texas",222107,131312,35987,61334,167299
728,0500000US48439,"Tarrant County, Texas",2028097,1267570,219571,419518,1487141
729,0500000US48441,"Taylor County, Texas",130195,78087,18760,34026,96847
730,0500000US48451,"Tom Green County, Texas",112485,67199,17564,21991,84763
731,0500000US48453,"Travis County, Texas",1204133,819946,114416,225973,934362
732,0500000US48469,"Victoria County, Texas",90641,53613,13948,24485,67561
733,0500000US48471,"Walker County, Texas",54677,36299,7484,18391,43783
734,0500000US48479,"Webb County, Texas",271839,155070,25134,114874,180204
735,0500000US48485,"Wichita County, Texas",116589,69267,18019,30240,87286
736,0500000US48491,"Williamson County, Texas",541890,335565,65406,59728,400971
737,0500000US48497,"Wise County, Texas",65004,39250,9758,13962,49008
738,0500000US49005,"Cache County, Utah",121408,73143,10858,32963,84001
739,0500000US49011,"Davis County, Utah",344999,197499,34981,34195,232480
740,0500000US49035,"Salt Lake County, Utah",1119482,695272,117682,176531,812954
741,0500000US49045,"Tooele County, Utah",66688,38977,5919,10493,44896
742,0500000US49049,"Utah County, Utah",591778,342736,45193,109931,387929
743,0500000US49053,"Washington County, Utah",164001,85887,34456,35300,120343
744,0500000US49057,"Weber County, Utah",248858,149727,27841,46374,177568
745,0500000US50007,"Chittenden County, Vermont",153087,101622,22743,30899,124365
746,0500000US51003,"Albemarle County, Virginia",101130,61640,17929,14226,79569
747,0500000US51013,"Arlington County, Virginia",231955,166820,23355,23092,190175
748,0500000US51015,"Augusta County, Virginia",71101,41778,15292,12800,57070
749,0500000US51019,"Bedford County, Virginia",77395,45765,16845,10252,62610
750,0500000US51041,"Chesterfield County, Virginia",339249,209578,48916,41276,258494
751,0500000US51059,"Fairfax County, Virginia",1139465,723165,148796,121557,871961
752,0500000US51061,"Fauquier County, Virginia",69117,41666,10796,4199,52462
753,0500000US51069,"Frederick County, Virginia",84916,50565,14382,10611,64947
754,0500000US51085,"Hanover County, Virginia",104222,62798,18006,8137,80804
755,0500000US51087,"Henrico County, Virginia",324311,202634,48058,50264,250692
756,0500000US51095,"James City County, Virginia",74624,40874,17862,8404,58736
757,0500000US51107,"Loudoun County, Virginia",396113,248397,35252,23401,283649
758,0500000US51121,"Montgomery County, Virginia",89129,62597,11683,28265,74280
759,0500000US51153,"Prince William County, Virginia",456586,289205,43412,51876,332617
760,0500000US51161,"Roanoke County, Virginia",91227,53816,19424,12203,73240
761,0500000US51165,"Rockingham County, Virginia",78162,45797,14937,13338,60734
762,0500000US51177,"Spotsylvania County, Virginia",132015,81441,17935,16077,99376
763,0500000US51179,"Stafford County, Virginia",142532,89794,14793,8335,104587
764,0500000US51199,"York County, Virginia",65446,39762,10042,6495,49804
765,0500000US51510,"Alexandria city, Virginia",158716,112683,17446,30001,130129
766,0500000US51550,"Chesapeake city, Virginia",236332,148055,30006,31196,178061
767,0500000US51650,"Hampton city, Virginia",129964,82342,19873,30021,102215
768,0500000US51680,"Lynchburg city, Virginia",70344,44424,10733,23403,55157
769,0500000US51700,"Newport News city, Virginia",170077,106669,22123,47399,128792
770,0500000US51710,"Norfolk city, Virginia",218546,144716,26210,63756,170926
771,0500000US51740,"Portsmouth city, Virginia",90280,56040,13501,23933,69541
772,0500000US51760,"Richmond city, Virginia",216268,149573,28132,79340,177705
773,0500000US51770,"Roanoke city, Virginia",98031,60730,16178,32463,76908
774,0500000US51800,"Suffolk city, Virginia",89378,55216,12666,16321,67882
775,0500000US51810,"Virginia Beach city, Virginia",440174,280537,60546,59337,341083
776,0500000US53005,"Benton County, Washington",196007,115688,28396,40852,144084
777,0500000US53007,"Chelan County, Washington",75153,43695,13714,19224,57409
778,0500000US53009,"Clallam County, Washington",74054,40116,21715,20848,61831
779,0500000US53011,"Clark County, Washington",469900,286475,70278,82709,356753
780,0500000US53015,"Cowlitz County, Washington",105513,62175,19281,29252,81456
781,0500000US53021,"Franklin County, Washington",89528,52296,8348,19795,60644
782,0500000US53025,"Grant County, Washington",94475,53318,12951,25459,66269
783,0500000US53027,"Grays Harbor County, Washington",69109,39857,14915,18679,54772
784,0500000US53029,"Island County, Washington",80701,45877,19742,12432,65619
785,0500000US53033,"King County, Washington",2160739,1439610,278475,314058,1718085
786,0500000US53035,"Kitsap County, Washington",258901,159169,45656,37610,204825
787,0500000US53041,"Lewis County, Washington",76706,44532,15975,19669,60507
788,0500000US53053,"Pierce County, Washington",860009,540858,115842,131722,656700
789,0500000US53057,"Skagit County, Washington",124076,71488,25254,21312,96742
790,0500000US53061,"Snohomish County, Washington",791342,509656,101815,93450,611471
791,0500000US53063,"Spokane County, Washington",492170,303361,77459,112410,380820
792,0500000US53067,"Thurston County, Washington",277061,169527,47107,47530,216634
793,0500000US53073,"Whatcom County, Washington",216298,136343,37091,47874,173434
794,0500000US53077,"Yakima County, Washington",246460,139956,33246,81809,173202
795,0500000US54003,"Berkeley County, West Virginia",114477,71293,16239,23281,87532
796,0500000US54011,"Cabell County, West Virginia",90572,55247,17195,33611,72442
797,0500000US54033,"Harrison County, West Virginia",66046,39637,12671,15438,52308
798,0500000US54039,"Kanawha County, West Virginia",180359,107372,36039,51345,143411
799,0500000US54061,"Monongalia County, West Virginia",99444,70611,12210,25860,82821
800,0500000US54081,"Raleigh County, West Virginia",72367,41933,14862,23240,56795
801,0500000US54107,"Wood County, West Virginia",83766,49652,16364,21643,66016
802,0500000US55009,"Brown County, Wisconsin",254471,156207,36457,46442,192664
803,0500000US55025,"Dane County, Wisconsin",522736,342926,70421,85457,413347
804,0500000US55027,"Dodge County, Wisconsin",82905,51782,14149,12296,65931
805,0500000US55035,"Eau Claire County, Wisconsin",99123,62990,15937,23907,78927
806,0500000US55039,"Fond du Lac County, Wisconsin",99172,59994,17797,14836,77791
807,0500000US55055,"Jefferson County, Wisconsin",81528,50404,13598,13469,64002
808,0500000US55059,"Kenosha County, Wisconsin",163934,103690,21904,30315,125594
809,0500000US55063,"La Crosse County, Wisconsin",113369,72198,17868,20532,90066
810,0500000US55071,"Manitowoc County, Wisconsin",78401,46838,15417,11968,62255
811,0500000US55073,"Marathon County, Wisconsin",133484,81063,22372,25098,103435
812,0500000US55079,"Milwaukee County, Wisconsin",929532,582232,122486,276049,704718
813,0500000US55087,"Outagamie County, Wisconsin",182448,113437,25841,24967,139278
814,0500000US55089,"Ozaukee County, Wisconsin",86478,50785,17101,6924,67886
815,0500000US55097,"Portage County, Wisconsin",67142,42753,11231,14528,53984
816,0500000US55101,"Racine County, Wisconsin",190946,115335,30347,39703,145682
817,0500000US55105,"Rock County, Wisconsin",159259,96623,25158,35233,121781
818,0500000US55109,"St. Croix County, Wisconsin",87565,53711,11598,6187,65309
819,0500000US55117,"Sheboygan County, Wisconsin",112332,67255,19737,17250,86992
820,0500000US55127,"Walworth County, Wisconsin",100075,61695,17329,17703,79024
821,0500000US55131,"Washington County, Wisconsin",134241,81624,22826,11822,104450
822,0500000US55133,"Waukesha County, Wisconsin",395240,237765,71933,33096,309698
823,0500000US55139,"Winnebago County, Wisconsin",162831,101789,26147,30135,127936
824,0500000US55141,"Wood County, Wisconsin",72049,42487,14324,15142,56811
825,0500000US56021,"Laramie County, Wyoming",96346,59230,14796,15391,74026
826,0500000US56025,"Natrona County, Wyoming",77303,46829,10833,14130,57662
827,0500000US72013,"Arecibo Municipio, Puerto Rico",85319,51009,18002,53147,69011
828,0500000US72021,"Bayamón Municipio, Puerto Rico",173218,102872,37466,88755,140338
829,0500000US72025,"Caguas Municipio, Puerto Rico",129400,78722,25305,69001,104027
830,0500000US72031,"Carolina Municipio, Puerto Rico",153736,91882,32939,63844,124821
831,0500000US72061,"Guaynabo Municipio, Puerto Rico",87077,53810,18477,33446,72287
832,0500000US72097,"Mayagüez Municipio, Puerto Rico",74407,44070,17373,46714,61443
833,0500000US72113,"Ponce Municipio, Puerto Rico",136612,79274,29098,95304,108372
834,0500000US72127,"San Juan Municipio, Puerto Rico",332876,198509,72642,176364,271151
835,0500000US72135,"Toa Alta Municipio, Puerto Rico",73129,47741,9909,34152,57650
836,0500000US72137,"Toa Baja Municipio, Puerto Rico",78034,47792,14614,39270,62406
837,0500000US72139,"Trujillo Alto Municipio, Puerto Rico",66453,40890,12261,26546,53151
