,GEO_ID,NAME,tot_poverty,pov_18_64,pov_65_up,pov_150,pov_18_up
1,0500000US01003,"Baldwin County, Alabama",205767,120071,40016,35989,160087
2,0500000US01015,"Calhoun County, Alabama",111622,68496,18439,33965,86935
3,0500000US01043,"Cullman County, Alabama",81136,48826,14680,20773,63506
4,0500000US01049,"DeKalb County, Alabama",69913,41536,11478,28127,53014
5,0500000US01051,"Elmore County, Alabama",77016,46930,11467,17267,58397
6,0500000US01055,"Etowah County, Alabama",101432,60909,18030,27748,78939
7,0500000US01069,"Houston County, Alabama",102975,61687,17330,32755,79017
8,0500000US01073,"Jefferson County, Alabama",646109,398144,97011,161988,495155
9,0500000US01077,"Lauderdale County, Alabama",90030,54736,16582,24439,71318
10,0500000US01081,"Lee County, Alabama",152844,102172,17288,41038,119460
11,0500000US01083,"Limestone County, Alabama",89756,55459,13137,21563,68596
12,0500000US01089,"Madison County, Alabama",348090,219899,50405,75029,270304
13,0500000US01095,"Marshall County, Alabama",93424,55334,15450,30872,70784
14,0500000US01097,"Mobile County, Alabama",404347,245330,62120,114720,307450
15,0500000US01101,"Montgomery County, Alabama",218667,136842,30949,67054,167791
16,0500000US01103,"Morgan County, Alabama",116996,70314,19552,30412,89866
17,0500000US01115,"St. Clair County, Alabama",85982,51572,14211,16453,65783
18,0500000US01117,"Shelby County, Alabama",207968,128343,29124,31843,157467
19,0500000US01121,"Talladega County, Alabama",76745,46058,13378,22769,59436
20,0500000US01125,"Tuscaloosa County, Alabama",195321,128230,24650,51656,152880
21,0500000US01127,"Walker County, Alabama",64145,37716,12128,21341,49844
22,0500000US02020,"Anchorage Municipality, Alaska",290571,189876,28172,35762,218048
23,0500000US02090,"Fairbanks North Star Borough, Alaska",96375,63753,8554,15063,72307
24,0500000US02170,"Matanuska-Susitna Borough, Alaska",102535,64181,10596,15663,74777
25,0500000US04001,"Apache County, Arizona",72147,40592,10633,32473,51225
26,0500000US04003,"Cochise County, Arizona",117620,64044,26333,39570,90377
27,0500000US04005,"Coconino County, Arizona",127592,82461,16510,35102,98971
28,0500000US04013,"Maricopa County, Arizona",4186451,2550778,613917,996595,3164695
29,0500000US04015,"Mohave County, Arizona",200525,105881,58633,57640,164514
30,0500000US04017,"Navajo County, Arizona",107257,58872,18096,44925,76968
31,0500000US04019,"Pima County, Arizona",987885,582116,191532,286702,773648
32,0500000US04021,"Pinal County, Arizona",390971,211259,83082,101613,294341
33,0500000US04025,"Yavapai County, Arizona",218023,116615,66915,52373,183530
34,0500000US04027,"Yuma County, Arizona",200375,110669,37779,65713,148448
35,0500000US05007,"Benton County, Arkansas",254895,153941,32676,49395,186617
36,0500000US05031,"Craighead County, Arkansas",101106,62268,13914,31949,76182
37,0500000US05045,"Faulkner County, Arkansas",116948,74500,14343,35436,88843
38,0500000US05051,"Garland County, Arkansas",95579,54617,20919,27941,75536
39,0500000US05069,"Jefferson County, Arkansas",64361,37717,10867,22333,48584
40,0500000US05085,"Lonoke County, Arkansas",71386,43599,9622,16667,53221
41,0500000US05119,"Pulaski County, Arkansas",386119,240159,55082,109058,295241
42,0500000US05125,"Saline County, Arkansas",117274,69625,20310,14006,89935
43,0500000US05131,"Sebastian County, Arkansas",126075,76365,19113,40901,95478
44,0500000US05143,"Washington County, Arkansas",220793,138769,25920,64110,164689
45,0500000US05145,"White County, Arkansas",75055,44695,12166,20975,56861
46,0500000US06001,"Alameda County, California",1621485,1068306,211331,267412,1279637
47,0500000US06007,"Butte County, California",220414,135785,39914,65872,175699
48,0500000US06013,"Contra Costa County, California",1125444,700532,167153,161728,867685
49,0500000US06017,"El Dorado County, California",184097,111316,35354,26786,146670
50,0500000US06019,"Fresno County, California",966379,574037,114036,359990,688073
51,0500000US06023,"Humboldt County, California",133208,84410,22770,43322,107180
52,0500000US06025,"Imperial County, California",171694,97133,22914,59840,120047
53,0500000US06029,"Kern County, California",852204,508793,89560,314259,598353
54,0500000US06031,"Kings County, California",134875,80558,14116,41771,94674
55,0500000US06033,"Lake County, California",63496,35317,14906,20560,50223
56,0500000US06037,"Los Angeles County, California",9989112,6485670,1281504,2693656,7767174
57,0500000US06039,"Madera County, California",146347,84713,19872,50091,104585
58,0500000US06041,"Marin County, California",254073,149023,52950,31299,201973
59,0500000US06045,"Mendocino County, California",86359,50132,17218,27956,67350
60,0500000US06047,"Merced County, California",263035,154967,28471,96607,183438
61,0500000US06053,"Monterey County, California",417791,250633,54132,103959,304765
62,0500000US06055,"Napa County, California",138247,84165,24749,18470,108914
63,0500000US06057,"Nevada County, California",98059,55335,25298,15394,80633
64,0500000US06059,"Orange County, California",3136217,1996094,437015,581583,2433109
65,0500000US06061,"Placer County, California",377789,222043,71105,47658,293148
66,0500000US06065,"Riverside County, California",2353864,1419395,328380,609457,1747775
67,0500000US06067,"Sacramento County, California",1494002,933414,203127,387654,1136541
68,0500000US06071,"San Bernardino County, California",2081216,1285240,231519,605110,1516759
69,0500000US06073,"San Diego County, California",3233771,2077943,438328,677340,2516271
70,0500000US06075,"San Francisco County, California",857255,614335,126801,141050,741136
71,0500000US06077,"San Joaquin County, California",720252,434233,88421,190305,522654
72,0500000US06079,"San Luis Obispo County, California",266721,163914,53285,45173,217199
73,0500000US06081,"San Mateo County, California",758012,485137,114096,81470,599233
74,0500000US06083,"Santa Barbara County, California",428197,264810,63949,103487,328759
75,0500000US06085,"Santa Clara County, California",1889316,1218935,240888,281328,1459823
76,0500000US06087,"Santa Cruz County, California",263072,169965,40442,57260,210407
77,0500000US06089,"Shasta County, California",176159,102887,35969,50875,138856
78,0500000US06095,"Solano County, California",428932,269270,63067,80681,332337
79,0500000US06097,"Sonoma County, California",495490,307201,90443,77629,397644
80,0500000US06099,"Stanislaus County, California",536626,323815,67809,151301,391624
81,0500000US06101,"Sutter County, California",95479,56715,14088,26157,70803
82,0500000US06107,"Tulare County, California",453738,264176,48898,182061,313074
83,0500000US06111,"Ventura County, California",837424,518679,122187,146701,640866
84,0500000US06113,"Yolo County, California",207888,137739,25406,57186,163145
85,0500000US06115,"Yuba County, California",73573,45120,8023,22153,53143
86,0500000US08001,"Adams County, Colorado",492398,309728,49094,105534,358822
87,0500000US08005,"Arapahoe County, Colorado",630769,401937,77556,94793,479493
88,0500000US08013,"Boulder County, Colorado",310494,205984,41806,52567,247790
89,0500000US08014,"Broomfield County, Colorado",66246,42177,8402,7913,50579
90,0500000US08031,"Denver County, Colorado",682515,467413,75667,153517,543080
91,0500000US08035,"Douglas County, Colorado",326841,202682,35983,19435,238665
92,0500000US08041,"El Paso County, Colorado",667991,419232,82253,130408,501485
93,0500000US08059,"Jefferson County, Colorado",562367,361077,87696,70339,448773
94,0500000US08069,"Larimer County, Colorado",331145,214870,49390,62083,264260
95,0500000US08077,"Mesa County, Colorado",147060,86997,26440,40171,113437
96,0500000US08101,"Pueblo County, Colorado",161407,95351,28519,48935,123870
97,0500000US08123,"Weld County, Colorado",288279,177276,33648,58154,210924
98,0500000US09001,"Fairfield County, Connecticut",925845,575731,135077,129949,710808
99,0500000US09003,"Hartford County, Connecticut",870087,542186,139636,150651,681822
100,0500000US09005,"Litchfield County, Connecticut",180678,111509,35375,22979,146884
101,0500000US09007,"Middlesex County, Connecticut",158051,98836,29290,20351,128126
102,0500000US09009,"New Haven County, Connecticut",830201,521648,134126,153225,655774
103,0500000US09011,"New London County, Connecticut",257750,160877,43997,40516,204874
104,0500000US09013,"Tolland County, Connecticut",135852,88020,21634,16101,109654
105,0500000US09015,"Windham County, Connecticut",111050,71414,17126,20613,88540
106,0500000US10001,"Kent County, Delaware",169798,101361,28379,37983,129740
107,0500000US10003,"New Castle County, Delaware",540302,341494,78560,95502,420054
108,0500000US10005,"Sussex County, Delaware",216764,120150,55696,35554,175846
109,0500000US11001,"District of Columbia, District of Columbia",647654,452477,76794,160646,529271
110,0500000US12001,"Alachua County, Florida",248007,167425,33574,84171,200999
111,0500000US12005,"Bay County, Florida",181492,111590,30461,44088,142051
112,0500000US12009,"Brevard County, Florida",573235,334954,132278,143922,467232
113,0500000US12011,"Broward County, Florida",1893618,1187919,302881,458422,1490800
114,0500000US12015,"Charlotte County, Florida",174558,83786,68391,41702,152177
115,0500000US12017,"Citrus County, Florida",139572,70810,50235,40588,121045
116,0500000US12019,"Clay County, Florida",206945,127173,30682,35707,157855
117,0500000US12021,"Collier County, Florida",362401,186610,112160,82107,298770
118,0500000US12023,"Columbia County, Florida",64115,37496,12129,18917,49625
119,0500000US12031,"Duval County, Florida",904630,575953,122134,216846,698087
120,0500000US12033,"Escambia County, Florida",296878,181558,50464,70677,232022
121,0500000US12035,"Flagler County, Florida",107767,56134,33007,25173,89141
122,0500000US12053,"Hernando County, Florida",180408,97070,49916,43048,146986
123,0500000US12055,"Highlands County, Florida",97965,48362,33703,34049,82065
124,0500000US12057,"Hillsborough County, Florida",1354249,858357,185791,337669,1044148
125,0500000US12061,"Indian River County, Florida",150348,77727,48012,38456,125739
126,0500000US12069,"Lake County, Florida",331863,178745,88076,72256,266821
127,0500000US12071,"Lee County, Florida",713021,387660,195524,163137,583184
128,0500000US12073,"Leon County, Florida",275796,187624,35024,79254,222648
129,0500000US12081,"Manatee County, Florida",371806,203650,98197,87173,301847
130,0500000US12083,"Marion County, Florida",337570,176433,98329,95097,274762
131,0500000US12085,"Martin County, Florida",155479,81763,47032,32752,128795
132,0500000US12086,"Miami-Dade County, Florida",2672145,1701422,424167,842469,2125589
133,0500000US12087,"Monroe County, Florida",77961,49136,17042,16122,66178
134,0500000US12089,"Nassau County, Florida",79711,47156,17013,12436,64169
135,0500000US12091,"Okaloosa County, Florida",195287,120396,31047,37810,151443
136,0500000US12095,"Orange County, Florida",1281519,844906,144149,355741,989055
137,0500000US12097,"Osceola County, Florida",334120,208451,43107,94294,251558
138,0500000US12099,"Palm Beach County, Florida",1424039,816423,331347,312334,1147770
139,0500000US12101,"Pasco County, Florida",504332,287967,114856,118773,402823
140,0500000US12103,"Pinellas County, Florida",946232,566218,222961,207913,789179
141,0500000US12105,"Polk County, Florida",652803,374202,131538,188691,505740
142,0500000US12107,"Putnam County, Florida",70904,40155,15539,25662,55694
143,0500000US12109,"St. Johns County, Florida",231315,137470,43792,29597,181262
144,0500000US12111,"St. Lucie County, Florida",303829,170909,71386,89657,242295
145,0500000US12113,"Santa Rosa County, Florida",163357,101187,25118,25717,126305
146,0500000US12115,"Sarasota County, Florida",407110,204739,143332,73421,348071
147,0500000US12117,"Seminole County, Florida",452332,288614,67836,86887,356450
148,0500000US12119,"Sumter County, Florida",114285,36593,69472,23199,106065
149,0500000US12127,"Volusia County, Florida",519158,303696,124133,132159,427829
150,0500000US12131,"Walton County, Florida",63804,38318,12720,10774,51038
151,0500000US13013,"Barrow County, Georgia",76668,47688,8776,18719,56464
152,0500000US13015,"Bartow County, Georgia",102749,63508,13508,28500,77016
153,0500000US13021,"Bibb County, Georgia",146422,87406,21687,53405,109093
154,0500000US13031,"Bulloch County, Georgia",66003,43675,8076,25118,51751
155,0500000US13045,"Carroll County, Georgia",112291,70117,14820,27708,84937
156,0500000US13047,"Catoosa County, Georgia",65625,39545,11141,10244,50686
157,0500000US13051,"Chatham County, Georgia",275625,173347,40679,71133,214026
158,0500000US13057,"Cherokee County, Georgia",239394,147976,31149,28089,179125
159,0500000US13059,"Clarke County, Georgia",114600,81401,12155,48181,93556
160,0500000US13063,"Clayton County, Georgia",273992,171009,24797,90768,195806
161,0500000US13067,"Cobb County, Georgia",737148,473422,84103,132922,557525
162,0500000US13073,"Columbia County, Georgia",146755,90524,18337,21096,108861
163,0500000US13077,"Coweta County, Georgia",138947,87028,17575,19986,104603
164,0500000US13089,"DeKalb County, Georgia",725695,473339,80501,200284,553840
165,0500000US13095,"Dougherty County, Georgia",86591,51860,12579,36804,64439
166,0500000US13097,"Douglas County, Georgia",140531,88069,15685,29895,103754
167,0500000US13113,"Fayette County, Georgia",111052,66180,19135,12079,85315
168,0500000US13115,"Floyd County, Georgia",92504,55346,14941,21457,70287
169,0500000US13117,"Forsyth County, Georgia",220212,132011,26453,22217,158464
170,0500000US13121,"Fulton County, Georgia",991572,651267,110666,230942,761933
171,0500000US13127,"Glynn County, Georgia",83335,49420,14699,23055,64119
172,0500000US13135,"Gwinnett County, Georgia",900628,569858,83933,180804,653791
173,0500000US13139,"Hall County, Georgia",194975,116482,27923,46280,144405
174,0500000US13151,"Henry County, Georgia",220488,138675,23799,42499,162474
175,0500000US13153,"Houston County, Georgia",149601,92819,18851,36371,111670
176,0500000US13179,"Liberty County, Georgia",60133,37750,5168,16023,42918
177,0500000US13185,"Lowndes County, Georgia",110404,69949,13260,33276,83209
178,0500000US13215,"Muscogee County, Georgia",189813,117320,24626,63801,141946
179,0500000US13217,"Newton County, Georgia",105573,64298,13021,33025,77319
180,0500000US13223,"Paulding County, Georgia",154632,96483,16661,27898,113144
181,0500000US13245,"Richmond County, Georgia",192296,120198,25987,70450,146185
182,0500000US13247,"Rockdale County, Georgia",88373,54168,11930,19472,66098
183,0500000US13285,"Troup County, Georgia",68200,41459,9547,20812,51006
184,0500000US13295,"Walker County, Georgia",66606,39852,11458,19294,51310
185,0500000US13297,"Walton County, Georgia",88636,53505,13067,20113,66572
186,0500000US13313,"Whitfield County, Georgia",103115,61467,13780,33049,75247
187,0500000US15001,"Hawaii County, Hawaii",195238,115301,37489,48904,152790
188,0500000US15003,"Honolulu County, Hawaii",960055,591858,160918,132480,752776
189,0500000US15007,"Kauai County, Hawaii",71444,42079,13252,9016,55331
190,0500000US15009,"Maui County, Hawaii",162611,100281,27055,26733,127336
191,0500000US16001,"Ada County, Idaho",436099,268071,60336,75503,328407
192,0500000US16005,"Bannock County, Idaho",82162,48731,11197,24560,59928
193,0500000US16019,"Bonneville County, Idaho",110716,61701,14753,21030,76454
194,0500000US16027,"Canyon County, Idaho",208114,118911,28004,60448,146915
195,0500000US16055,"Kootenai County, Idaho",152436,90403,27199,34602,117602
196,0500000US16083,"Twin Falls County, Idaho",82244,47042,12254,23427,59296
197,0500000US17001,"Adams County, Illinois",65050,38446,11846,13270,50292
198,0500000US17019,"Champaign County, Illinois",192334,130678,23603,54733,154281
199,0500000US17031,"Cook County, Illinois",5115390,3284041,683118,1232109,3967159
200,0500000US17037,"DeKalb County, Illinois",99374,65382,11608,24475,76990
201,0500000US17043,"DuPage County, Illinois",916826,574875,129192,106830,704067
202,0500000US17089,"Kane County, Illinois",525815,322663,65478,95493,388141
203,0500000US17091,"Kankakee County, Illinois",105009,63398,16528,25085,79926
204,0500000US17093,"Kendall County, Illinois",124323,75825,12696,9110,88521
205,0500000US17097,"Lake County, Illinois",686476,423958,89330,98910,513288
206,0500000US17099,"LaSalle County, Illinois",107025,64670,19075,21721,83745
207,0500000US17111,"McHenry County, Illinois",304326,192584,38973,37311,231557
208,0500000US17113,"McLean County, Illinois",165270,107758,20075,34922,127833
209,0500000US17115,"Macon County, Illinois",102860,60377,19403,27583,79780
210,0500000US17119,"Madison County, Illinois",260035,160774,41866,53892,202640
211,0500000US17143,"Peoria County, Illinois",179735,108119,27917,42237,136036
212,0500000US17161,"Rock Island County, Illinois",140156,82677,25543,31722,108220
213,0500000US17163,"St. Clair County, Illinois",258219,160006,36944,65229,196950
214,0500000US17167,"Sangamon County, Illinois",193978,117732,31742,43327,149474
215,0500000US17179,"Tazewell County, Illinois",131213,78399,23226,21954,101625
216,0500000US17183,"Vermilion County, Illinois",75100,43046,13806,21813,56852
217,0500000US17197,"Will County, Illinois",678930,421629,82024,85099,503653
218,0500000US17199,"Williamson County, Illinois",65207,38768,11821,13848,50589
219,0500000US17201,"Winnebago County, Illinois",281748,169586,45869,74635,215455
220,0500000US18003,"Allen County, Indiana",364233,220932,48706,90290,269638
221,0500000US18005,"Bartholomew County, Indiana",80491,49166,12094,16053,61260
222,0500000US18019,"Clark County, Indiana",114188,70886,16881,22813,87767
223,0500000US18035,"Delaware County, Indiana",108670,69771,18115,34491,87886
224,0500000US18039,"Elkhart County, Indiana",200273,117324,27243,48817,144567
225,0500000US18043,"Floyd County, Indiana",75625,47314,11360,11396,58674
226,0500000US18053,"Grant County, Indiana",62016,36121,12212,20749,48333
227,0500000US18057,"Hamilton County, Indiana",314679,191222,35904,27181,227126
228,0500000US18059,"Hancock County, Indiana",73005,44572,11117,11702,55689
229,0500000US18063,"Hendricks County, Indiana",156168,95727,20106,14694,115833
230,0500000US18067,"Howard County, Indiana",81582,47374,15620,21884,62994
231,0500000US18081,"Johnson County, Indiana",149784,90508,20863,19250,111371
232,0500000US18085,"Kosciusko County, Indiana",77254,46353,12233,14309,58586
233,0500000US18089,"Lake County, Indiana",477973,292251,72781,118400,365032
234,0500000US18091,"LaPorte County, Indiana",101946,60880,17643,25350,78523
235,0500000US18095,"Madison County, Indiana",122986,73606,22292,34695,95898
236,0500000US18097,"Marion County, Indiana",923062,586335,106816,273108,693151
237,0500000US18105,"Monroe County, Indiana",130827,91533,16794,45019,108327
238,0500000US18109,"Morgan County, Indiana",68322,42717,10675,12329,53392
239,0500000US18127,"Porter County, Indiana",162848,101107,25245,24237,126352
240,0500000US18141,"St. Joseph County, Indiana",256660,154743,38734,66868,193477
241,0500000US18157,"Tippecanoe County, Indiana",170492,112839,19045,45980,131884
242,0500000US18163,"Vanderburgh County, Indiana",176007,108937,27740,50265,136677
243,0500000US18167,"Vigo County, Indiana",99114,61649,15978,28930,77627
244,0500000US18177,"Wayne County, Indiana",63649,37822,12028,15287,49850
245,0500000US19013,"Black Hawk County, Iowa",127273,78947,20270,31089,99217
246,0500000US19049,"Dallas County, Iowa",83975,50847,9449,8846,60296
247,0500000US19061,"Dubuque County, Iowa",93267,55519,15942,15792,71461
248,0500000US19103,"Johnson County, Iowa",137349,93254,14963,35085,108217
249,0500000US19113,"Linn County, Iowa",216207,133019,32020,36727,165039
250,0500000US19153,"Polk County, Iowa",465060,291113,56360,80741,347473
251,0500000US19155,"Pottawattamie County, Iowa",90984,54670,15083,17144,69753
252,0500000US19163,"Scott County, Iowa",169095,102828,25380,35418,128208
253,0500000US19169,"Story County, Iowa",87337,61652,10665,26908,72317
254,0500000US19193,"Woodbury County, Iowa",99639,58400,14906,22922,73306
255,0500000US20015,"Butler County, Kansas",63834,38000,9162,10200,47162
256,0500000US20045,"Douglas County, Kansas",111540,76817,13089,26537,89906
257,0500000US20091,"Johnson County, Kansas",578369,357798,77502,58269,435300
258,0500000US20103,"Leavenworth County, Kansas",74769,45302,10409,9842,55711
259,0500000US20161,"Riley County, Kansas",64266,46564,5860,17236,52424
260,0500000US20173,"Sedgwick County, Kansas",506343,306220,67347,120921,373567
261,0500000US20177,"Shawnee County, Kansas",173231,102374,29310,34831,131684
262,0500000US20209,"Wyandotte County, Kansas",162251,98313,18305,50579,116618
263,0500000US21015,"Boone County, Kentucky",127141,77744,15367,18400,93111
264,0500000US21029,"Bullitt County, Kentucky",78467,49538,11393,13449,60931
265,0500000US21037,"Campbell County, Kentucky",89285,57269,12854,16724,70123
266,0500000US21047,"Christian County, Kentucky",65409,38846,7424,25382,46270
267,0500000US21059,"Daviess County, Kentucky",96681,57493,15601,26005,73094
268,0500000US21067,"Fayette County, Kentucky",305674,202489,37389,83103,239878
269,0500000US21093,"Hardin County, Kentucky",103928,64370,13867,22099,78237
270,0500000US21111,"Jefferson County, Kentucky",749670,468080,113252,174326,581332
271,0500000US21117,"Kenton County, Kentucky",162289,102400,21154,33443,123554
272,0500000US21145,"McCracken County, Kentucky",63365,37968,11853,19569,49821
273,0500000US21151,"Madison County, Kentucky",82102,52824,11148,25573,63972
274,0500000US21185,"Oldham County, Kentucky",61561,37423,7490,5647,44913
275,0500000US21227,"Warren County, Kentucky",117629,74557,15209,36959,89766
276,0500000US22005,"Ascension Parish, Louisiana",120715,74203,13227,18256,87430
277,0500000US22015,"Bossier Parish, Louisiana",121475,74405,16037,33524,90442
278,0500000US22017,"Caddo Parish, Louisiana",243972,146907,37633,93262,184540
279,0500000US22019,"Calcasieu Parish, Louisiana",197322,120689,27094,64116,147783
280,0500000US22033,"East Baton Rouge Parish, Louisiana",436889,280165,57483,120689,337648
281,0500000US22045,"Iberia Parish, Louisiana",71607,42711,10114,27179,52825
282,0500000US22051,"Jefferson Parish, Louisiana",432415,269653,68576,105768,338229
283,0500000US22055,"Lafayette Parish, Louisiana",234994,152135,27551,67222,179686
284,0500000US22057,"Lafourche Parish, Louisiana",94725,59617,13785,24903,73402
285,0500000US22063,"Livingston Parish, Louisiana",138609,85108,17535,31042,102643
286,0500000US22071,"Orleans Parish, Louisiana",375903,247423,49476,130434,296899
287,0500000US22073,"Ouachita Parish, Louisiana",151613,90536,21586,55368,112122
288,0500000US22079,"Rapides Parish, Louisiana",128616,76949,19458,42076,96407
289,0500000US22097,"St. Landry Parish, Louisiana",82335,47686,12474,31737,60160
290,0500000US22103,"St. Tammany Parish, Louisiana",250658,150692,39634,42885,190326
291,0500000US22105,"Tangipahoa Parish, Louisiana",127260,78427,17176,40172,95603
292,0500000US22109,"Terrebonne Parish, Louisiana",111735,68180,14714,39521,82894
293,0500000US23001,"Androscoggin County, Maine",103997,64453,17179,23738,81632
294,0500000US23003,"Aroostook County, Maine",66017,39208,14509,19418,53717
295,0500000US23005,"Cumberland County, Maine",284544,180684,48560,44760,229244
296,0500000US23011,"Kennebec County, Maine",117079,73021,20682,27422,93703
297,0500000US23019,"Penobscot County, Maine",145608,92591,25710,36518,118301
298,0500000US23031,"York County, Maine",198757,122621,37924,28601,160545
299,0500000US24001,"Allegany County, Maryland",64481,38981,12980,16675,51961
300,0500000US24003,"Anne Arundel County, Maryland",551674,347062,77903,63476,424965
301,0500000US24005,"Baltimore County, Maryland",810257,501415,133054,111981,634469
302,0500000US24009,"Calvert County, Maryland",90529,56373,12796,8460,69169
303,0500000US24013,"Carroll County, Maryland",164242,101678,26430,12853,128108
304,0500000US24015,"Cecil County, Maryland",101361,63508,14558,14521,78066
305,0500000US24017,"Charles County, Maryland",154382,98376,18473,19478,116849
306,0500000US24021,"Frederick County, Maryland",242242,152271,32818,26827,185089
307,0500000US24025,"Harford County, Maryland",247787,155137,37899,31656,193036
308,0500000US24027,"Howard County, Maryland",313906,196884,40640,24026,237524
309,0500000US24031,"Montgomery County, Maryland",1036302,644682,148351,126724,793033
310,0500000US24033,"Prince George's County, Maryland",889371,578448,109904,134548,688352
311,0500000US24037,"St. Mary's County, Maryland",108874,68850,13221,18473,82071
312,0500000US24043,"Washington County, Maryland",141144,85573,23113,31404,108686
313,0500000US24045,"Wicomico County, Maryland",98975,61612,14906,30105,76518
314,0500000US24510,"Baltimore city, Maryland",593353,390265,76226,183477,466491
315,0500000US25001,"Barnstable County, Massachusetts",211578,116353,62180,27719,178533
316,0500000US25003,"Berkshire County, Massachusetts",120532,72713,26528,21154,99241
317,0500000US25005,"Bristol County, Massachusetts",543781,341753,87373,93997,429126
318,0500000US25009,"Essex County, Massachusetts",762523,473166,123213,133276,596379
319,0500000US25011,"Franklin County, Massachusetts",69228,43719,13421,11724,57140
320,0500000US25013,"Hampden County, Massachusetts",453049,280950,71622,114882,352572
321,0500000US25015,"Hampshire County, Massachusetts",139152,89839,25490,25623,115329
322,0500000US25017,"Middlesex County, Massachusetts",1533815,992788,224083,182607,1216871
323,0500000US25021,"Norfolk County, Massachusetts",679183,422907,108891,64875,531798
324,0500000US25023,"Plymouth County, Massachusetts",503524,306706,85602,57808,392308
325,0500000US25025,"Suffolk County, Massachusetts",739133,521421,85661,208269,607082
326,0500000US25027,"Worcester County, Massachusetts",790732,501015,116613,118955,617628
327,0500000US26005,"Allegan County, Michigan",114080,68350,17966,19597,86316
328,0500000US26017,"Bay County, Michigan",103429,62957,19486,26647,82443
329,0500000US26021,"Berrien County, Michigan",150113,88188,27965,39876,116153
330,0500000US26025,"Calhoun County, Michigan",130685,78196,22415,36977,100611
331,0500000US26037,"Clinton County, Michigan",77205,47140,12380,11594,59520
332,0500000US26045,"Eaton County, Michigan",107192,66134,18591,19692,84725
333,0500000US26049,"Genesee County, Michigan",404281,245120,66240,124418,311360
334,0500000US26055,"Grand Traverse County, Michigan",89688,54321,16728,14995,71049
335,0500000US26065,"Ingham County, Michigan",269277,177739,35437,78404,213176
336,0500000US26073,"Isabella County, Michigan",64722,44496,8019,21855,52515
337,0500000US26075,"Jackson County, Michigan",148983,89752,25626,33232,115378
338,0500000US26077,"Kalamazoo County, Michigan",252877,161439,36283,63654,197722
339,0500000US26081,"Kent County, Michigan",630913,395791,79659,129394,475450
340,0500000US26087,"Lapeer County, Michigan",86772,53696,14798,19373,68494
341,0500000US26091,"Lenawee County, Michigan",93488,56361,16459,19835,72820
342,0500000US26093,"Livingston County, Michigan",187232,116648,29594,18339,146242
343,0500000US26099,"Macomb County, Michigan",859990,537414,137572,161968,674986
344,0500000US26103,"Marquette County, Michigan",62151,38863,11335,15701,50198
345,0500000US26111,"Midland County, Michigan",81940,50315,14118,14090,64433
346,0500000US26115,"Monroe County, Michigan",148024,90953,24546,28342,115499
347,0500000US26121,"Muskegon County, Michigan",166881,99986,27149,49374,127135
348,0500000US26125,"Oakland County, Michigan",1233237,773365,194484,169592,967849
349,0500000US26139,"Ottawa County, Michigan",272156,166674,38326,41783,205000
350,0500000US26145,"Saginaw County, Michigan",185941,111846,34004,47785,145850
351,0500000US26147,"St. Clair County, Michigan",157777,96907,27340,34151,124247
352,0500000US26155,"Shiawassee County, Michigan",67817,41730,11558,14457,53288
353,0500000US26159,"Van Buren County, Michigan",74396,44281,12437,23200,56718
354,0500000US26161,"Washtenaw County, Michigan",344193,229792,46215,74057,276007
355,0500000US26163,"Wayne County, Michigan",1727249,1068781,246277,577174,1315058
356,0500000US27003,"Anoka County, Minnesota",342476,216266,44076,42190,260342
357,0500000US27013,"Blue Earth County, Minnesota",62829,42163,8326,15213,50489
358,0500000US27019,"Carver County, Minnesota",99427,62053,10757,6603,72810
359,0500000US27037,"Dakota County, Minnesota",414759,259175,53664,46878,312839
360,0500000US27053,"Hennepin County, Minnesota",1210680,785119,157442,210699,942561
361,0500000US27109,"Olmsted County, Minnesota",150736,91717,22087,23666,113804
362,0500000US27123,"Ramsey County, Minnesota",526683,331276,70951,125803,402227
363,0500000US27131,"Rice County, Minnesota",57438,34265,9251,9768,43516
364,0500000US27137,"St. Louis County, Minnesota",191912,119978,34632,49251,154610
365,0500000US27139,"Scott County, Minnesota",141753,88655,12990,14612,101645
366,0500000US27141,"Sherburne County, Minnesota",91391,56066,9485,13121,65551
367,0500000US27145,"Stearns County, Minnesota",148268,92509,21018,29614,113527
368,0500000US27163,"Washington County, Minnesota",249061,152368,34627,18309,186995
369,0500000US27171,"Wright County, Minnesota",131489,79017,15519,11485,94536
370,0500000US28033,"DeSoto County, Mississippi",174452,107826,21277,32741,129103
371,0500000US28035,"Forrest County, Mississippi",71904,45392,9770,26836,55162
372,0500000US28047,"Harrison County, Mississippi",196964,122451,27358,63035,149809
373,0500000US28049,"Hinds County, Mississippi",232616,144701,30358,67915,175059
374,0500000US28059,"Jackson County, Mississippi",139746,85850,20302,34406,106152
375,0500000US28067,"Jones County, Mississippi",66567,38765,10451,21241,49216
376,0500000US28075,"Lauderdale County, Mississippi",74701,43395,12363,27138,55758
377,0500000US28081,"Lee County, Mississippi",83656,50900,11872,21412,62772
378,0500000US28089,"Madison County, Mississippi",103491,63900,13232,19184,77132
379,0500000US28121,"Rankin County, Mississippi",145142,89017,20433,24845,109450
380,0500000US29019,"Boone County, Missouri",167490,112261,19867,47054,132128
381,0500000US29021,"Buchanan County, Missouri",85022,52050,13074,22365,65124
382,0500000US29031,"Cape Girardeau County, Missouri",75637,47202,11834,18608,59036
383,0500000US29037,"Cass County, Missouri",100916,60705,16119,16919,76824
384,0500000US29043,"Christian County, Missouri",83693,49508,12620,18774,62128
385,0500000US29047,"Clay County, Missouri",235041,146978,31504,37858,178482
386,0500000US29051,"Cole County, Missouri",71559,43500,11220,13376,54720
387,0500000US29071,"Franklin County, Missouri",101488,61436,16707,18126,78143
388,0500000US29077,"Greene County, Missouri",276997,173800,44388,83153,218188
389,0500000US29095,"Jackson County, Missouri",680346,424185,93712,168842,517897
390,0500000US29097,"Jasper County, Missouri",117086,70677,16752,30511,87429
391,0500000US29099,"Jefferson County, Missouri",221472,138679,30638,38594,169317
392,0500000US29165,"Platte County, Missouri",97664,61032,13217,10398,74249
393,0500000US29183,"St. Charles County, Missouri",381823,235931,54092,33664,290023
394,0500000US29187,"St. Francois County, Missouri",59961,36043,10100,14183,46143
395,0500000US29189,"St. Louis County, Missouri",978259,596185,164543,149885,760728
396,0500000US29510,"St. Louis city, Missouri",302641,206281,35248,108258,241529
397,0500000US30013,"Cascade County, Montana",79509,47165,14577,19419,61742
398,0500000US30029,"Flathead County, Montana",97077,58437,17223,21117,75660
399,0500000US30031,"Gallatin County, Montana",100808,67500,12321,20036,79821
400,0500000US30049,"Lewis and Clark County, Montana",65794,39298,11858,11391,51156
401,0500000US30063,"Missoula County, Montana",113356,75182,16355,29767,91537
402,0500000US30111,"Yellowstone County, Montana",154535,93428,24856,31511,118284
403,0500000US31055,"Douglas County, Nebraska",542214,336292,65186,111070,401478
404,0500000US31109,"Lancaster County, Nebraska",296442,186683,39437,58923,226120
405,0500000US31153,"Sarpy County, Nebraska",175799,109013,19118,19502,128131
406,0500000US32003,"Clark County, Nevada",2126703,1328813,301056,520745,1629869
407,0500000US32031,"Washoe County, Nevada",448512,279515,70582,99983,350097
408,0500000US33005,"Cheshire County, New Hampshire",70960,44446,13560,12965,58006
409,0500000US33009,"Grafton County, New Hampshire",82084,51095,16797,14371,67892
410,0500000US33011,"Hillsborough County, New Hampshire",399477,257251,57888,51992,315139
411,0500000US33013,"Merrimack County, New Hampshire",141743,88846,24672,16520,113518
412,0500000US33015,"Rockingham County, New Hampshire",300909,192096,48915,23909,241011
413,0500000US33017,"Strafford County, New Hampshire",118401,77282,17552,13506,94834
414,0500000US34001,"Atlantic County, New Jersey",264653,163160,44502,61948,207662
415,0500000US34003,"Bergen County, New Jersey",928064,578729,150408,108370,729137
416,0500000US34005,"Burlington County, New Jersey",437635,273618,70800,45675,344418
417,0500000US34007,"Camden County, New Jersey",503489,313435,73612,95356,387047
418,0500000US34009,"Cape May County, New Jersey",92325,52700,23171,17757,75871
419,0500000US34011,"Cumberland County, New Jersey",141057,83366,21403,47413,104769
420,0500000US34013,"Essex County, New Jersey",776820,491295,99024,211427,590319
421,0500000US34015,"Gloucester County, New Jersey",288178,180617,42929,35630,223546
422,0500000US34017,"Hudson County, New Jersey",669511,460129,72353,163608,532482
423,0500000US34019,"Hunterdon County, New Jersey",120416,76056,20545,7557,96601
424,0500000US34021,"Mercer County, New Jersey",354404,224815,51301,64335,276116
425,0500000US34023,"Middlesex County, New Jersey",807146,510296,115742,105603,626038
426,0500000US34025,"Monmouth County, New Jersey",620230,384124,101581,72052,485705
427,0500000US34027,"Morris County, New Jersey",491534,305871,78241,44648,384112
428,0500000US34029,"Ocean County, New Jersey",585713,318136,128648,114725,446784
429,0500000US34031,"Passaic County, New Jersey",499804,310707,67188,136028,377895
430,0500000US34033,"Salem County, New Jersey",62115,37584,10976,14252,48560
431,0500000US34035,"Somerset County, New Jersey",330384,208277,47989,28225,256266
432,0500000US34037,"Sussex County, New Jersey",141737,90423,22143,14583,112566
433,0500000US34039,"Union County, New Jersey",549148,346199,72701,98184,418900
434,0500000US34041,"Warren County, New Jersey",105124,66176,17257,15596,83433
435,0500000US35001,"Bernalillo County, New Mexico",669062,417612,101392,188658,519004
436,0500000US35005,"Chaves County, New Mexico",63417,36320,9557,23385,45877
437,0500000US35013,"Doña Ana County, New Mexico",208446,123293,32263,89033,155556
438,0500000US35025,"Lea County, New Mexico",67384,39018,7138,20898,46156
439,0500000US35031,"McKinley County, New Mexico",74081,43918,8204,38676,52122
440,0500000US35035,"Otero County, New Mexico",61997,36054,10510,20909,46564
441,0500000US35043,"Sandoval County, New Mexico",141076,84298,23098,33414,107396
442,0500000US35045,"San Juan County, New Mexico",113095,67155,17103,29446,84258
443,0500000US35049,"Santa Fe County, New Mexico",146132,85904,32662,34822,118566
444,0500000US35061,"Valencia County, New Mexico",73657,43467,12489,23471,55956
445,0500000US36001,"Albany County, New York",293203,190493,46238,54997,236731
446,0500000US36005,"Bronx County, New York",1421501,900687,161463,580852,1062150
447,0500000US36007,"Broome County, New York",184627,113595,34185,47417,147780
448,0500000US36009,"Cattaraugus County, New York",75162,44623,13442,19099,58065
449,0500000US36011,"Cayuga County, New York",73403,45395,12998,16598,58393
450,0500000US36013,"Chautauqua County, New York",124169,74376,23474,36611,97850
451,0500000US36015,"Chemung County, New York",81113,48181,14914,17730,63095
452,0500000US36019,"Clinton County, New York",72997,46917,12775,16498,59692
453,0500000US36027,"Dutchess County, New York",276437,174489,46560,41800,221049
454,0500000US36029,"Erie County, New York",895844,556322,152797,197839,709119
455,0500000US36045,"Jefferson County, New York",106771,65127,14575,28666,79702
456,0500000US36047,"Kings County, New York",2603170,1676452,326794,810877,2003246
457,0500000US36051,"Livingston County, New York",57804,36773,10302,12800,47075
458,0500000US36053,"Madison County, New York",66390,41367,11652,11436,53019
459,0500000US36055,"Monroe County, New York",723337,449692,117657,159949,567349
460,0500000US36059,"Nassau County, New York",1341195,823572,225748,135167,1049320
461,0500000US36061,"New York County, New York",1596749,1118940,239777,397735,1358717
462,0500000US36063,"Niagara County, New York",207782,128350,37517,41943,165867
463,0500000US36065,"Oneida County, New York",218945,132074,39487,50753,171561
464,0500000US36067,"Onondaga County, New York",447035,276099,72135,96433,348234
465,0500000US36069,"Ontario County, New York",106299,63871,20525,17124,84396
466,0500000US36071,"Orange County, New York",370372,226046,48304,70010,274350
467,0500000US36075,"Oswego County, New York",113729,71356,17751,30145,89107
468,0500000US36079,"Putnam County, New York",97699,61967,15608,10159,77575
469,0500000US36081,"Queens County, New York",2306296,1515877,321996,535474,1837873
470,0500000US36083,"Rensselaer County, New York",154337,98687,24224,28835,122911
471,0500000US36085,"Richmond County, New York",470477,296141,70719,93298,366860
472,0500000US36087,"Rockland County, New York",322405,183030,49465,72444,232495
473,0500000US36089,"St. Lawrence County, New York",97298,58928,17126,24044,76054
474,0500000US36091,"Saratoga County, New York",223420,140366,36712,24803,177078
475,0500000US36093,"Schenectady County, New York",150526,93148,24077,25694,117225
476,0500000US36101,"Steuben County, New York",94895,57777,16923,24052,74700
477,0500000US36103,"Suffolk County, New York",1464253,915717,232660,175020,1148377
478,0500000US36105,"Sullivan County, New York",72201,42941,13217,16724,56158
479,0500000US36109,"Tompkins County, New York",90843,63316,13076,23695,76392
480,0500000US36111,"Ulster County, New York",171126,106997,32538,37359,139535
481,0500000US36113,"Warren County, New York",63835,38823,13261,11323,52084
482,0500000US36117,"Wayne County, New York",88425,54842,15582,16990,70424
483,0500000US36119,"Westchester County, New York",951318,583297,152481,154429,735778
484,0500000US37001,"Alamance County, North Carolina",154927,94441,25640,43520,120081
485,0500000US37019,"Brunswick County, North Carolina",125961,68236,37708,29649,105944
486,0500000US37021,"Buncombe County, North Carolina",249284,155011,47009,63081,202020
487,0500000US37023,"Burke County, North Carolina",86383,52630,17082,25643,69712
488,0500000US37025,"Cabarrus County, North Carolina",199547,122386,25373,41241,147759
489,0500000US37027,"Caldwell County, North Carolina",80293,49263,14985,27090,64248
490,0500000US37031,"Carteret County, North Carolina",67923,39392,16058,15704,55450
491,0500000US37035,"Catawba County, North Carolina",153678,92469,26501,35232,118970
492,0500000US37037,"Chatham County, North Carolina",71561,39222,17463,14653,56685
493,0500000US37045,"Cleveland County, North Carolina",94773,57072,17155,32597,74227
494,0500000US37049,"Craven County, North Carolina",99498,58799,18599,23415,77398
495,0500000US37051,"Cumberland County, North Carolina",315237,197153,36661,97938,233814
496,0500000US37057,"Davidson County, North Carolina",162060,97706,28558,42927,126264
497,0500000US37063,"Durham County, North Carolina",293222,192816,35136,72695,227952
498,0500000US37067,"Forsyth County, North Carolina",361719,220302,54533,103168,274835
499,0500000US37071,"Gaston County, North Carolina",214018,132316,32805,56616,165121
500,0500000US37081,"Guilford County, North Carolina",504936,314255,73469,147925,387724
501,0500000US37085,"Harnett County, North Carolina",127123,77821,15041,35182,92862
502,0500000US37089,"Henderson County, North Carolina",112393,62900,28340,21659,91240
503,0500000US37097,"Iredell County, North Carolina",171501,105593,25745,36977,131338
504,0500000US37101,"Johnston County, North Carolina",189355,116502,23548,47042,140050
505,0500000US37109,"Lincoln County, North Carolina",80456,50289,13046,16062,63335
506,0500000US37119,"Mecklenburg County, North Carolina",1039837,678015,109116,217500,787131
507,0500000US37125,"Moore County, North Carolina",94695,52226,22408,21027,74634
508,0500000US37127,"Nash County, North Carolina",92320,56135,16007,26249,72142
509,0500000US37129,"New Hanover County, North Carolina",216812,138807,36567,60748,175374
510,0500000US37133,"Onslow County, North Carolina",173578,110069,17072,45945,127141
511,0500000US37135,"Orange County, North Carolina",131284,85589,17038,24808,102627
512,0500000US37147,"Pitt County, North Carolina",170253,112184,20384,51101,132568
513,0500000US37151,"Randolph County, North Carolina",141686,85573,23614,39700,109187
514,0500000US37155,"Robeson County, North Carolina",129490,78249,18142,54050,96391
515,0500000US37157,"Rockingham County, North Carolina",90091,54421,16937,27743,71358
516,0500000US37159,"Rowan County, North Carolina",136073,82305,22384,37774,104689
517,0500000US37161,"Rutherford County, North Carolina",64996,38210,13766,19354,51976
518,0500000US37171,"Surry County, North Carolina",71296,41992,13947,23797,55939
519,0500000US37179,"Union County, North Carolina",223412,135151,26790,36630,161941
520,0500000US37183,"Wake County, North Carolina",1023722,661065,109019,158552,770084
521,0500000US37191,"Wayne County, North Carolina",120609,73573,18258,39291,91831
522,0500000US37193,"Wilkes County, North Carolina",67795,40160,13397,17732,53557
523,0500000US37195,"Wilson County, North Carolina",80118,47914,13240,26706,61154
524,0500000US38015,"Burleigh County, North Dakota",90186,55978,13456,11726,69434
525,0500000US38017,"Cass County, North Dakota",170513,112748,18941,31218,131689
526,0500000US38035,"Grand Forks County, North Dakota",66478,44695,8051,16734,52746
527,0500000US38101,"Ward County, North Dakota",67905,43871,7939,10829,51810
528,0500000US39003,"Allen County, Ohio",99245,59113,16476,24902,75589
529,0500000US39007,"Ashtabula County, Ohio",95092,56218,17263,29328,73481
530,0500000US39009,"Athens County, Ohio",56229,39637,7465,22115,47102
531,0500000US39013,"Belmont County, Ohio",64382,39216,12632,15126,51848
532,0500000US39017,"Butler County, Ohio",365103,226981,50514,70362,277495
533,0500000US39023,"Clark County, Ohio",131522,77497,23815,38695,101312
534,0500000US39025,"Clermont County, Ohio",201198,124286,29986,39976,154272
535,0500000US39029,"Columbiana County, Ohio",99637,59525,19281,26467,78806
536,0500000US39035,"Cuyahoga County, Ohio",1223032,756246,205419,328409,961665
537,0500000US39041,"Delaware County, Ohio",193858,116800,24202,14418,141002
538,0500000US39043,"Erie County, Ohio",73914,43258,15593,13980,58851
539,0500000US39045,"Fairfield County, Ohio",149461,90455,22276,23380,112731
540,0500000US39049,"Franklin County, Ohio",1232457,801353,139791,305729,941144
541,0500000US39055,"Geauga County, Ohio",93295,54508,17235,10308,71743
542,0500000US39057,"Greene County, Ohio",156460,96193,26231,28608,122424
543,0500000US39061,"Hamilton County, Ohio",791246,492956,113887,186017,606843
544,0500000US39063,"Hancock County, Ohio",72966,45193,12012,13225,57205
545,0500000US39081,"Jefferson County, Ohio",64550,38513,12766,16662,51279
546,0500000US39085,"Lake County, Ohio",224744,138192,41386,33536,179578
547,0500000US39089,"Licking County, Ohio",167748,100671,26734,35728,127405
548,0500000US39093,"Lorain County, Ohio",297035,177471,51094,61681,228565
549,0500000US39095,"Lucas County, Ohio",422755,260143,64827,123770,324970
550,0500000US39099,"Mahoning County, Ohio",223603,134008,43989,63193,177997
551,0500000US39101,"Marion County, Ohio",58630,35731,10198,14785,45929
552,0500000US39103,"Medina County, Ohio",175255,106786,28660,19330,135446
553,0500000US39109,"Miami County, Ohio",103068,61272,18406,16870,79678
554,0500000US39113,"Montgomery County, Ohio",515687,310339,88316,140556,398655
555,0500000US39119,"Muskingum County, Ohio",83540,49915,14337,22823,64252
556,0500000US39133,"Portage County, Ohio",154628,100408,24077,34435,124485
557,0500000US39139,"Richland County, Ohio",113376,66753,21462,30833,88215
558,0500000US39141,"Ross County, Ohio",70950,43162,11781,20446,54943
559,0500000US39145,"Scioto County, Ohio",72338,43808,12243,22929,56051
560,0500000US39151,"Stark County, Ohio",363927,218460,66416,78954,284876
561,0500000US39153,"Summit County, Ohio",530101,328175,89592,119612,417767
562,0500000US39155,"Trumbull County, Ohio",197989,116819,39593,52460,156412
563,0500000US39157,"Tuscarawas County, Ohio",91468,54219,16299,21292,70518
564,0500000US39165,"Warren County, Ohio",219628,132961,29903,22248,162864
565,0500000US39169,"Wayne County, Ohio",112358,65867,18720,25922,84587
566,0500000US39173,"Wood County, Ohio",123199,78659,18443,24497,97102
567,0500000US40017,"Canadian County, Oklahoma",134063,81999,16778,26112,98777
568,0500000US40027,"Cleveland County, Oklahoma",265643,171406,33930,56013,205336
569,0500000US40031,"Comanche County, Oklahoma",112173,70467,13397,31061,83864
570,0500000US40037,"Creek County, Oklahoma",69968,41689,11765,18955,53454
571,0500000US40101,"Muskogee County, Oklahoma",65556,38000,10766,22178,48766
572,0500000US40109,"Oklahoma County, Oklahoma",766221,467630,99064,210857,566694
573,0500000US40119,"Payne County, Oklahoma",73352,48214,9698,27709,57912
574,0500000US40125,"Pottawatomie County, Oklahoma",69202,40869,11113,20563,51982
575,0500000US40131,"Rogers County, Oklahoma",90306,54274,14335,14470,68609
576,0500000US40143,"Tulsa County, Oklahoma",633092,387886,84516,158091,472402
577,0500000US40145,"Wagoner County, Oklahoma",77148,46394,11712,15787,58106
578,0500000US41003,"Benton County, Oregon",83681,55277,13516,23954,68793
579,0500000US41005,"Clackamas County, Oregon",403989,248841,68805,53461,317646
580,0500000US41017,"Deschutes County, Oregon",180329,108048,35231,28903,143279
581,0500000US41019,"Douglas County, Oregon",107019,60408,26095,30474,86503
582,0500000US41029,"Jackson County, Oregon",214580,125019,44874,54653,169893
583,0500000US41033,"Josephine County, Oregon",84426,47264,21973,31302,69237
584,0500000US41035,"Klamath County, Oregon",65509,38061,13266,20149,51327
585,0500000US41039,"Lane County, Oregon",361357,227049,67384,103999,294433
586,0500000US41043,"Linn County, Oregon",121995,71963,22212,28067,94175
587,0500000US41047,"Marion County, Oregon",326419,194969,49781,88043,244750
588,0500000US41051,"Multnomah County, Oregon",785692,534796,99059,174156,633855
589,0500000US41053,"Polk County, Oregon",80393,47787,14255,14794,62042
590,0500000US41059,"Umatilla County, Oregon",71491,41342,10890,19298,52232
591,0500000US41067,"Washington County, Oregon",578160,368852,72740,92630,441592
592,0500000US41071,"Yamhill County, Oregon",100099,59456,16891,21612,76347
593,0500000US42001,"Adams County, Pennsylvania",97719,58385,19298,16952,77683
594,0500000US42003,"Allegheny County, Pennsylvania",1192434,749552,213781,218825,963333
595,0500000US42005,"Armstrong County, Pennsylvania",65781,39342,13941,15218,53283
596,0500000US42007,"Beaver County, Pennsylvania",164521,98938,33371,29933,132309
597,0500000US42011,"Berks County, Pennsylvania",401618,244588,65858,87345,310446
598,0500000US42013,"Blair County, Pennsylvania",121835,72695,23830,26985,96525
599,0500000US42017,"Bucks County, Pennsylvania",617837,381782,107330,67486,489112
600,0500000US42019,"Butler County, Pennsylvania",180988,111302,32565,21562,143867
601,0500000US42021,"Cambria County, Pennsylvania",127652,74794,27988,30133,102782
602,0500000US42025,"Carbon County, Pennsylvania",62408,38173,12393,12954,50566
603,0500000US42027,"Centre County, Pennsylvania",142595,97889,20544,33141,118433
604,0500000US42029,"Chester County, Pennsylvania",503420,309150,76586,57482,385736
605,0500000US42033,"Clearfield County, Pennsylvania",75146,45314,15220,18099,60534
606,0500000US42037,"Columbia County, Pennsylvania",61095,38222,11592,13471,49814
607,0500000US42039,"Crawford County, Pennsylvania",82331,48507,16369,19923,64876
608,0500000US42041,"Cumberland County, Pennsylvania",234763,143328,41829,32395,185157
609,0500000US42043,"Dauphin County, Pennsylvania",268800,166990,41890,54084,208880
610,0500000US42045,"Delaware County, Pennsylvania",542743,334162,85396,93646,419558
611,0500000US42049,"Erie County, Pennsylvania",263197,161270,43557,67305,204827
612,0500000US42051,"Fayette County, Pennsylvania",128923,77845,25565,37825,103410
613,0500000US42055,"Franklin County, Pennsylvania",151719,88813,28662,25715,117475
614,0500000US42063,"Indiana County, Pennsylvania",80760,50004,15400,24747,65404
615,0500000US42069,"Lackawanna County, Pennsylvania",203627,121910,39608,49340,161518
616,0500000US42071,"Lancaster County, Pennsylvania",525628,312004,87559,98652,399563
617,0500000US42073,"Lawrence County, Pennsylvania",85144,50551,17381,19577,67932
618,0500000US42075,"Lebanon County, Pennsylvania",134998,79194,24659,24905,103853
619,0500000US42077,"Lehigh County, Pennsylvania",353947,215741,56657,83734,272398
620,0500000US42079,"Luzerne County, Pennsylvania",304813,185712,57837,75390,243549
621,0500000US42081,"Lycoming County, Pennsylvania",109152,65627,20169,23883,85796
622,0500000US42085,"Mercer County, Pennsylvania",105586,62237,22056,25233,84293
623,0500000US42089,"Monroe County, Pennsylvania",163291,104211,26213,31949,130424
624,0500000US42091,"Montgomery County, Pennsylvania",799565,488829,134791,91278,623620
625,0500000US42095,"Northampton County, Pennsylvania",290635,178191,52695,41317,230886
626,0500000US42097,"Northumberland County, Pennsylvania",88485,52910,17647,22809,70557
627,0500000US42101,"Philadelphia County, Pennsylvania",1523651,990424,194107,554628,1184531
628,0500000US42107,"Schuylkill County, Pennsylvania",136225,81655,27081,28702,108736
629,0500000US42111,"Somerset County, Pennsylvania",70041,41331,15258,15999,56589
630,0500000US42125,"Washington County, Pennsylvania",202913,123214,39329,32511,162543
631,0500000US42129,"Westmoreland County, Pennsylvania",348796,208342,75444,56036,283786
632,0500000US42133,"York County, Pennsylvania",434108,265813,71916,74370,337729
633,0500000US44003,"Kent County, Rhode Island",163114,103851,28591,26968,132442
634,0500000US44005,"Newport County, Rhode Island",79114,47387,16733,10971,64120
635,0500000US44007,"Providence County, Rhode Island",608297,389603,88395,142984,477998
636,0500000US44009,"Washington County, Rhode Island",120185,74951,23939,17072,98890
637,0500000US45003,"Aiken County, South Carolina",164649,99346,29680,50356,129026
638,0500000US45007,"Anderson County, South Carolina",193577,115598,33617,50254,149215
639,0500000US45013,"Beaufort County, South Carolina",177979,95735,47055,28491,142790
640,0500000US45015,"Berkeley County, South Carolina",207389,129385,27326,43348,156711
641,0500000US45019,"Charleston County, South Carolina",383982,246752,59537,86768,306289
642,0500000US45031,"Darlington County, South Carolina",65663,39224,11604,19829,50828
643,0500000US45035,"Dorchester County, South Carolina",151577,93515,19745,23707,113260
644,0500000US45041,"Florence County, South Carolina",135177,81089,21521,37515,102610
645,0500000US45045,"Greenville County, South Carolina",486802,298895,73562,103245,372457
646,0500000US45047,"Greenwood County, South Carolina",67046,38852,11859,24636,50711
647,0500000US45051,"Horry County, South Carolina",317564,187118,71050,86007,258168
648,0500000US45057,"Lancaster County, South Carolina",87422,50863,17335,16246,68198
649,0500000US45059,"Laurens County, South Carolina",64311,39161,10807,19880,49968
650,0500000US45063,"Lexington County, South Carolina",282714,174071,42209,53104,216280
651,0500000US45073,"Oconee County, South Carolina",75420,43395,17020,19619,60415
652,0500000US45075,"Orangeburg County, South Carolina",85269,49461,15460,29627,64921
653,0500000US45077,"Pickens County, South Carolina",116568,73660,19212,30405,92872
654,0500000US45079,"Richland County, South Carolina",379486,243638,48437,97671,292075
655,0500000US45083,"Spartanburg County, South Carolina",292495,177988,46273,77503,224261
656,0500000US45085,"Sumter County, South Carolina",105018,62794,16259,33534,79053
657,0500000US45091,"York County, South Carolina",254226,156929,34896,46799,191825
658,0500000US46099,"Minnehaha County, South Dakota",182739,112549,23226,32440,135775
659,0500000US46103,"Pennington County, South Dakota",106621,63793,17792,28394,81585
660,0500000US47001,"Anderson County, Tennessee",74240,45113,14069,15794,59182
661,0500000US47009,"Blount County, Tennessee",126642,75632,24518,23588,100150
662,0500000US47011,"Bradley County, Tennessee",100443,62591,16502,24865,79093
663,0500000US47037,"Davidson County, Tennessee",664028,443540,76886,160293,520426
664,0500000US47059,"Greene County, Tennessee",66289,39661,14188,18236,53849
665,0500000US47065,"Hamilton County, Tennessee",347318,215961,57189,76248,273150
666,0500000US47093,"Knox County, Tennessee",444725,281428,67821,103679,349249
667,0500000US47113,"Madison County, Tennessee",94064,56605,15316,30891,71921
668,0500000US47119,"Maury County, Tennessee",88697,54134,13753,16579,67887
669,0500000US47125,"Montgomery County, Tennessee",191608,122524,17109,44326,139633
670,0500000US47141,"Putnam County, Tennessee",72886,44413,12459,25098,56872
671,0500000US47147,"Robertson County, Tennessee",68108,41947,9424,13721,51371
672,0500000US47149,"Rutherford County, Tennessee",302748,196322,30847,54458,227169
673,0500000US47155,"Sevier County, Tennessee",95728,57139,17530,24891,74669
674,0500000US47157,"Shelby County, Tennessee",915486,568935,114444,277456,683379
675,0500000US47163,"Sullivan County, Tennessee",154265,91745,32406,42317,124151
676,0500000US47165,"Sumner County, Tennessee",178323,108299,27167,31792,135466
677,0500000US47179,"Washington County, Tennessee",122934,76390,21843,33043,98233
678,0500000US47187,"Williamson County, Tennessee",218766,132054,26211,22818,158265
679,0500000US47189,"Wilson County, Tennessee",131203,80048,19866,16988,99914
680,0500000US48005,"Angelina County, Texas",84913,49968,12826,25276,62794
681,0500000US48021,"Bastrop County, Texas",80346,49098,11665,17905,60763
682,0500000US48027,"Bell County, Texas",330694,202282,34181,74681,236463
683,0500000US48029,"Bexar County, Texas",1895930,1179944,220835,513113,1400779
684,0500000US48037,"Bowie County, Texas",87940,51091,14562,24038,65653
685,0500000US48039,"Brazoria County, Texas",342548,210928,38281,53882,249209
686,0500000US48041,"Brazos County, Texas",205036,140924,19086,71026,160010
687,0500000US48061,"Cameron County, Texas",416883,234293,54346,189662,288639
688,0500000US48085,"Collin County, Texas",935794,589388,96796,104602,686184
689,0500000US48091,"Comal County, Texas",133570,79980,23755,21872,103735
690,0500000US48099,"Coryell County, Texas",59524,35791,6800,16135,42591
691,0500000US48113,"Dallas County, Texas",2546156,1609889,254674,722868,1864563
692,0500000US48121,"Denton County, Texas",792031,514789,74283,112313,589072
693,0500000US48135,"Ector County, Texas",155506,93718,14648,34482,108366
694,0500000US48139,"Ellis County, Texas",166345,101173,20582,25154,121755
695,0500000US48141,"El Paso County, Texas",822857,494488,98129,309392,592617
696,0500000US48157,"Fort Bend County, Texas",735455,455107,76297,105785,531404
697,0500000US48167,"Galveston County, Texas",321896,199987,42834,68820,242821
698,0500000US48181,"Grayson County, Texas",125553,73139,22116,26716,95255
699,0500000US48183,"Gregg County, Texas",119930,70981,17126,42827,88107
700,0500000US48187,"Guadalupe County, Texas",153180,93033,20491,27303,113524
701,0500000US48201,"Harris County, Texas",4543604,2878115,440499,1243162,3318614
702,0500000US48203,"Harrison County, Texas",64801,38135,10008,20393,48143
703,0500000US48209,"Hays County, Texas",196461,128630,21354,40476,149984
704,0500000US48213,"Henderson County, Texas",78211,44765,16537,23674,61302
705,0500000US48215,"Hidalgo County, Texas",840303,467501,91984,391701,559485
706,0500000US48231,"Hunt County, Texas",89509,53850,13470,23077,67320
707,0500000US48245,"Jefferson County, Texas",237168,144562,33036,72401,177598
708,0500000US48251,"Johnson County, Texas",160014,95268,22695,32541,117963
709,0500000US48257,"Kaufman County, Texas",116386,70964,13639,23744,84603
710,0500000US48291,"Liberty County, Texas",73465,42203,10427,20019,52630
711,0500000US48303,"Lubbock County, Texas",290613,183614,35168,89413,218782
712,0500000US48309,"McLennan County, Texas",238441,144841,33074,73212,177915
713,0500000US48329,"Midland County, Texas",159851,98433,16051,23433,114484
714,0500000US48339,"Montgomery County, Texas",551552,336226,69283,101435,405509
715,0500000US48347,"Nacogdoches County, Texas",60283,36333,8458,23333,44791
716,0500000US48355,"Nueces County, Texas",352062,214665,48917,86946,263582
717,0500000US48361,"Orange County, Texas",83821,50178,12743,19180,62921
718,0500000US48367,"Parker County, Texas",127849,76403,19482,21587,95885
719,0500000US48375,"Potter County, Texas",113562,66725,13905,40403,80630
720,0500000US48381,"Randall County, Texas",129257,79947,18352,20240,98299
721,0500000US48397,"Rockwall County, Texas",93266,56220,11394,9386,67614
722,0500000US48409,"San Patricio County, Texas",66872,39217,9584,19507,48801
723,0500000US48423,"Smith County, Texas",220744,130458,34855,58480,165313
724,0500000US48439,"Tarrant County, Texas",1992012,1245438,211685,455764,1457123
725,0500000US48441,"Taylor County, Texas",130428,78649,18812,36632,97461
726,0500000US48451,"Tom Green County, Texas",112663,67732,17319,26593,85051
727,0500000US48453,"Travis County, Texas",1175370,801355,106103,232084,907458
728,0500000US48469,"Victoria County, Texas",91272,54104,13966,20556,68070
729,0500000US48471,"Walker County, Texas",54426,36305,7293,15521,43598
730,0500000US48479,"Webb County, Texas",267800,152115,24123,124708,176238
731,0500000US48485,"Wichita County, Texas",115726,69599,17281,32274,86880
732,0500000US48491,"Williamson County, Texas",523001,323142,62223,61108,385365
733,0500000US49005,"Cache County, Utah",120282,71873,10998,28225,82871
734,0500000US49011,"Davis County, Utah",339477,196160,32088,39400,228248
735,0500000US49035,"Salt Lake County, Utah",1107530,686617,112296,191570,798913
736,0500000US49049,"Utah County, Utah",577259,334004,43491,114483,377495
737,0500000US49053,"Washington County, Utah",158612,83318,32439,35321,115757
738,0500000US49057,"Weber County, Utah",244936,146339,27777,44937,174116
739,0500000US50007,"Chittenden County, Vermont",151667,101055,21778,26404,122833
740,0500000US51003,"Albemarle County, Virginia",100116,60825,17850,14757,78675
741,0500000US51013,"Arlington County, Virginia",227212,165152,21422,28836,186574
742,0500000US51015,"Augusta County, Virginia",71508,42549,14548,11431,57097
743,0500000US51019,"Bedford County, Virginia",77596,45538,15945,13325,61483
744,0500000US51041,"Chesterfield County, Virginia",335542,207244,47449,40917,254693
745,0500000US51059,"Fairfax County, Virginia",1127062,720144,139757,120327,859901
746,0500000US51061,"Fauquier County, Virginia",68737,41899,10717,5992,52616
747,0500000US51069,"Frederick County, Virginia",82234,49943,13455,8057,63398
748,0500000US51085,"Hanover County, Virginia",102647,62638,17147,8347,79785
749,0500000US51087,"Henrico County, Virginia",323582,201997,46966,44768,248963
750,0500000US51095,"James City County, Virginia",73306,39738,18432,6661,58170
751,0500000US51107,"Loudoun County, Virginia",384206,240766,33370,25258,274136
752,0500000US51121,"Montgomery County, Virginia",89399,63085,11029,24831,74114
753,0500000US51153,"Prince William County, Virginia",448160,285214,41016,60450,326230
754,0500000US51161,"Roanoke County, Virginia",91774,54036,18717,15046,72753
755,0500000US51165,"Rockingham County, Virginia",77420,45779,14698,12635,60477
756,0500000US51177,"Spotsylvania County, Virginia",130852,81349,17204,15247,98553
757,0500000US51179,"Stafford County, Virginia",139711,88809,14086,13737,102895
758,0500000US51199,"York County, Virginia",66704,39953,10188,5622,50141
759,0500000US51510,"Alexandria city, Virginia",154399,110937,15160,29158,126097
760,0500000US51550,"Chesapeake city, Virginia",231402,145969,29121,33585,175090
761,0500000US51650,"Hampton city, Virginia",130659,83457,19163,30474,102620
762,0500000US51680,"Lynchburg city, Virginia",69636,43846,10640,17257,54486
763,0500000US51700,"Newport News city, Virginia",171629,109356,21675,39144,131031
764,0500000US51710,"Norfolk city, Virginia",219577,145552,24702,66331,170254
765,0500000US51740,"Portsmouth city, Virginia",91222,56689,13105,25560,69794
766,0500000US51760,"Richmond city, Virginia",212912,147414,25900,79484,173314
767,0500000US51770,"Roanoke city, Virginia",97651,61579,14425,35309,76004
768,0500000US51800,"Suffolk city, Virginia",88863,54789,12046,16856,66835
769,0500000US51810,"Virginia Beach city, Virginia",441559,281945,58570,63080,340515
770,0500000US53005,"Benton County, Washington",191799,113456,27148,39609,140604
771,0500000US53007,"Chelan County, Washington",75241,43484,13839,15212,57323
772,0500000US53009,"Clallam County, Washington",73226,39671,20558,18250,60229
773,0500000US53011,"Clark County, Washington",462673,281825,67644,75143,349469
774,0500000US53015,"Cowlitz County, Washington",102921,60869,19541,22656,80410
775,0500000US53021,"Franklin County, Washington",87697,50427,7025,24000,57452
776,0500000US53025,"Grant County, Washington",92867,53278,12434,30799,65712
777,0500000US53027,"Grays Harbor County, Washington",68531,40056,14015,16075,54071
778,0500000US53029,"Island County, Washington",80747,46574,19346,16792,65920
779,0500000US53033,"King County, Washington",2121364,1414736,267516,305987,1682252
780,0500000US53035,"Kitsap County, Washington",257823,160202,43888,43610,204090
781,0500000US53041,"Lewis County, Washington",75632,43940,16219,22190,60159
782,0500000US53053,"Pierce County, Washington",846011,531195,112915,156678,644110
783,0500000US53057,"Skagit County, Washington",122028,71725,23731,22398,95456
784,0500000US53061,"Snohomish County, Washington",776892,500261,99279,112019,599540
785,0500000US53063,"Spokane County, Washington",484224,300326,75232,111146,375558
786,0500000US53067,"Thurston County, Washington",271713,168151,44582,49370,212733
787,0500000US53073,"Whatcom County, Washington",211532,134475,35090,48023,169565
788,0500000US53077,"Yakima County, Washington",245955,139701,32871,75379,172572
789,0500000US54003,"Berkeley County, West Virginia",112823,70174,15942,25404,86116
790,0500000US54011,"Cabell County, West Virginia",92110,56960,16240,31559,73200
791,0500000US54033,"Harrison County, West Virginia",67224,40473,12395,17290,52868
792,0500000US54039,"Kanawha County, West Virginia",182780,110965,34669,48738,145634
793,0500000US54061,"Monongalia County, West Virginia",98653,69481,12149,26640,81630
794,0500000US54081,"Raleigh County, West Virginia",73392,43288,14692,21234,57980
795,0500000US54107,"Wood County, West Virginia",84709,50453,16276,23157,66729
796,0500000US55009,"Brown County, Wisconsin",252608,156708,35075,43954,191783
797,0500000US55025,"Dane County, Wisconsin",517108,341611,66021,83530,407632
798,0500000US55027,"Dodge County, Wisconsin",83732,52129,14191,14663,66320
799,0500000US55035,"Eau Claire County, Wisconsin",98864,62828,14884,21135,77712
800,0500000US55039,"Fond du Lac County, Wisconsin",98723,59815,16991,16272,76806
801,0500000US55055,"Jefferson County, Wisconsin",81430,50097,13174,14589,63271
802,0500000US55059,"Kenosha County, Wisconsin",163259,103316,21593,33040,124909
803,0500000US55063,"La Crosse County, Wisconsin",113153,72460,17529,25321,89989
804,0500000US55071,"Manitowoc County, Wisconsin",78138,47500,15085,15034,62585
805,0500000US55073,"Marathon County, Wisconsin",133545,81051,22345,26133,103396
806,0500000US55079,"Milwaukee County, Wisconsin",930552,584921,116875,273698,701796
807,0500000US55087,"Outagamie County, Wisconsin",181126,113367,24495,27758,137862
808,0500000US55089,"Ozaukee County, Wisconsin",86468,51071,16274,9756,67345
809,0500000US55097,"Portage County, Wisconsin",66741,42846,10852,13569,53698
810,0500000US55101,"Racine County, Wisconsin",190367,115403,30081,41853,145484
811,0500000US55105,"Rock County, Wisconsin",158185,95978,24824,35734,120802
812,0500000US55109,"St. Croix County, Wisconsin",86983,53774,11186,9488,64960
813,0500000US55117,"Sheboygan County, Wisconsin",112281,67161,19515,15281,86676
814,0500000US55127,"Walworth County, Wisconsin",100101,62006,16182,17424,78188
815,0500000US55131,"Washington County, Wisconsin",133381,81084,22144,10820,103228
816,0500000US55133,"Waukesha County, Wisconsin",393833,238614,68855,35454,307469
817,0500000US55139,"Winnebago County, Wisconsin",161187,101217,25938,30655,127155
818,0500000US55141,"Wood County, Wisconsin",72220,43209,13770,11863,56979
819,0500000US56021,"Laramie County, Wyoming",95656,59157,14290,15826,73447
820,0500000US56025,"Natrona County, Wyoming",79005,49338,10475,13846,59813
821,0500000US72013,"Arecibo Municipio, Puerto Rico",87259,52409,17807,53486,70216
822,0500000US72021,"Bayamón Municipio, Puerto Rico",178068,106458,36959,91101,143417
823,0500000US72025,"Caguas Municipio, Puerto Rico",131624,80103,24810,69661,104913
824,0500000US72031,"Carolina Municipio, Puerto Rico",157566,94318,32713,76583,127031
825,0500000US72061,"Guaynabo Municipio, Puerto Rico",88848,55178,18198,34060,73376
826,0500000US72097,"Mayagüez Municipio, Puerto Rico",76921,45627,17288,52429,62915
827,0500000US72113,"Ponce Municipio, Puerto Rico",141420,82807,28605,90566,111412
828,0500000US72127,"San Juan Municipio, Puerto Rico",340979,204262,71396,182027,275658
829,0500000US72135,"Toa Alta Municipio, Puerto Rico",73760,47959,9568,36427,57527
830,0500000US72137,"Toa Baja Municipio, Puerto Rico",80061,48952,14414,41673,63366
831,0500000US72139,"Trujillo Alto Municipio, Puerto Rico",67970,41970,11802,28871,53772
