,GEO_ID,NAME,tot_poverty,pov_18_64,pov_65_up,pov_150,pov_18_up
1,0500000US01003,"Baldwin County, Alabama",214740,124431,43483,36705,167914
2,0500000US01015,"Calhoun County, Alabama",111061,66953,20192,35852,87145
3,0500000US01043,"Cullman County, Alabama",82209,48090,15405,20871,63495
4,0500000US01049,"DeKalb County, Alabama",70157,41495,11993,24735,53488
5,0500000US01051,"Elmore County, Alabama",77240,47131,11904,14266,59035
6,0500000US01055,"Etowah County, Alabama",100867,60506,19134,28593,79640
7,0500000US01069,"Houston County, Alabama",103515,61388,18487,28818,79875
8,0500000US01073,"Jefferson County, Alabama",643119,394338,102321,156629,496659
9,0500000US01077,"Lauderdale County, Alabama",90384,54550,18064,20247,72614
10,0500000US01081,"Lee County, Alabama",157870,103597,19728,45888,123325
11,0500000US01083,"Limestone County, Alabama",93095,55896,14998,19525,70894
12,0500000US01089,"Madison County, Alabama",357121,222755,55051,71012,277806
13,0500000US01095,"Marshall County, Alabama",94435,55271,15978,27770,71249
14,0500000US01097,"Mobile County, Alabama",406968,246160,65430,134405,311590
15,0500000US01101,"Montgomery County, Alabama",218245,133428,33261,66311,166689
16,0500000US01103,"Morgan County, Alabama",117592,70539,20063,26985,90602
17,0500000US01115,"St. Clair County, Alabama",86702,51833,14530,17405,66363
18,0500000US01117,"Shelby County, Alabama",211940,131309,32879,31003,164188
19,0500000US01121,"Talladega County, Alabama",76270,46043,14126,24645,60169
20,0500000US01125,"Tuscaloosa County, Alabama",198260,128145,26913,49590,155058
21,0500000US01127,"Walker County, Alabama",62727,37150,11829,18399,48979
22,0500000US02020,"Anchorage Municipality, Alaska",285536,183258,31759,38939,215017
23,0500000US02090,"Fairbanks North Star Borough, Alaska",94455,61291,10147,16276,71438
24,0500000US02170,"Matanuska-Susitna Borough, Alaska",105239,63837,12965,17938,76802
25,0500000US04001,"Apache County, Arizona",70749,40419,10860,36383,51279
26,0500000US04003,"Cochise County, Arizona",119305,64377,28263,31319,92640
27,0500000US04005,"Coconino County, Arizona",129038,82536,17689,32614,100225
28,0500000US04013,"Maricopa County, Arizona",4355605,2655645,662728,892988,3318373
29,0500000US04015,"Mohave County, Arizona",205705,107249,63216,58575,170465
30,0500000US04017,"Navajo County, Arizona",107624,58705,20067,48135,78772
31,0500000US04019,"Pima County, Arizona",1010866,594354,203475,258951,797829
32,0500000US04021,"Pinal County, Arizona",418346,229389,89732,93887,319121
33,0500000US04025,"Yavapai County, Arizona",226881,117473,73151,55298,190624
34,0500000US04027,"Yuma County, Arizona",205802,113377,39721,75324,153098
35,0500000US05007,"Benton County, Arkansas",268354,162906,35530,46480,198436
36,0500000US05031,"Craighead County, Arkansas",104628,63526,14560,31565,78086
37,0500000US05045,"Faulkner County, Arkansas",119579,75548,15377,31046,90925
38,0500000US05051,"Garland County, Arkansas",97515,55542,22535,29933,78077
39,0500000US05069,"Jefferson County, Arkansas",60796,35247,11124,20797,46371
40,0500000US05085,"Lonoke County, Arkansas",72534,44671,9373,16455,54044
41,0500000US05119,"Pulaski County, Arkansas",386172,237832,58941,107061,296773
42,0500000US05125,"Saline County, Arkansas",119734,70829,21316,20138,92145
43,0500000US05131,"Sebastian County, Arkansas",126053,76358,19374,37421,95732
44,0500000US05143,"Washington County, Arkansas",228416,146109,25918,61329,172027
45,0500000US05145,"White County, Arkansas",74785,45069,11989,22707,57058
46,0500000US06001,"Alameda County, California",1642667,1076107,226406,223038,1302513
47,0500000US06007,"Butte County, California",226193,138457,42119,67843,180576
48,0500000US06013,"Contra Costa County, California",1141015,705725,178779,153459,884504
49,0500000US06017,"El Dorado County, California",189589,111409,40221,26971,151630
50,0500000US06019,"Fresno County, California",975927,580398,119119,335662,699517
51,0500000US06023,"Humboldt County, California",132985,83505,24056,42708,107561
52,0500000US06025,"Imperial County, California",171991,97884,23344,61660,121228
53,0500000US06029,"Kern County, California",866580,514949,96483,284943,611432
54,0500000US06031,"Kings County, California",137060,82340,14828,41261,97168
55,0500000US06033,"Lake County, California",62940,35552,14632,17485,50184
56,0500000US06037,"Los Angeles County, California",9953165,6443780,1347942,2401547,7791722
57,0500000US06039,"Madera County, California",149208,84643,21635,50649,106278
58,0500000US06041,"Marin County, California",253650,144998,57296,24440,202294
59,0500000US06045,"Mendocino County, California",85879,48960,18763,21934,67723
60,0500000US06047,"Merced County, California",268968,158554,30551,90298,189105
61,0500000US06053,"Monterey County, California",418664,247627,58424,91292,306051
62,0500000US06055,"Napa County, California",136739,81621,26236,20361,107857
63,0500000US06057,"Nevada County, California",98694,54519,27172,17576,81691
64,0500000US06059,"Orange County, California",3148187,1994966,464567,537598,2459533
65,0500000US06061,"Placer County, California",389406,226946,75623,44373,302569
66,0500000US06065,"Riverside County, California",2411413,1454429,349585,528004,1804014
67,0500000US06067,"Sacramento County, California",1522720,948373,214448,355483,1162821
68,0500000US06071,"San Bernardino County, California",2121692,1313029,246620,533822,1559649
69,0500000US06073,"San Diego County, California",3259203,2082196,462988,630055,2545184
70,0500000US06075,"San Francisco County, California",869727,617051,135949,134992,753000
71,0500000US06077,"San Joaquin County, California",735733,442873,92595,185396,535468
72,0500000US06079,"San Luis Obispo County, California",267624,161953,56784,48389,218737
73,0500000US06081,"San Mateo County, California",764657,485305,121881,85299,607186
74,0500000US06083,"Santa Barbara County, California",426201,263069,67215,92096,330284
75,0500000US06085,"Santa Clara County, California",1907047,1230241,256920,230089,1487161
76,0500000US06087,"Santa Cruz County, California",261414,166218,44742,49645,210960
77,0500000US06089,"Shasta County, California",176694,103294,36313,40657,139607
78,0500000US06095,"Solano County, California",435952,269174,69113,61066,338287
79,0500000US06097,"Sonoma County, California",493293,300104,96495,85724,396599
80,0500000US06099,"Stanislaus County, California",546057,327485,71062,144461,398547
81,0500000US06101,"Sutter County, California",95346,56652,14513,20505,71165
82,0500000US06107,"Tulare County, California",460709,267808,51376,167812,319184
83,0500000US06111,"Ventura County, California",838307,516372,130663,144376,647035
84,0500000US06113,"Yolo County, California",212296,139696,26699,62973,166395
85,0500000US06115,"Yuba County, California",76394,46321,9345,21383,55666
86,0500000US08001,"Adams County, Colorado",507674,320932,52220,89552,373152
87,0500000US08005,"Arapahoe County, Colorado",645350,410571,83552,91701,494123
88,0500000US08013,"Boulder County, Colorado",313578,206945,45055,47022,252000
89,0500000US08014,"Broomfield County, Colorado",68937,43656,9449,7975,53105
90,0500000US08031,"Denver County, Colorado",704493,483331,82102,133779,565433
91,0500000US08035,"Douglas County, Colorado",341204,213330,39690,13313,253020
92,0500000US08041,"El Paso County, Colorado",694772,434488,90258,115923,524746
93,0500000US08059,"Jefferson County, Colorado",570424,364064,93738,66015,457802
94,0500000US08069,"Larimer County, Colorado",340970,218691,53963,54628,272654
95,0500000US08077,"Mesa County, Colorado",150185,88539,28439,39693,116978
96,0500000US08101,"Pueblo County, Colorado",163507,96704,29978,44625,126682
97,0500000US08123,"Weld County, Colorado",306619,187213,38000,56833,225213
98,0500000US09001,"Fairfield County, Connecticut",926707,571352,145361,148887,716713
99,0500000US09003,"Hartford County, Connecticut",873964,540547,147661,165083,688208
100,0500000US09005,"Litchfield County, Connecticut",178648,109389,37017,22431,146406
101,0500000US09007,"Middlesex County, Connecticut",157215,97682,31092,16659,128774
102,0500000US09009,"New Haven County, Connecticut",829382,515542,143225,151229,658767
103,0500000US09011,"New London County, Connecticut",255099,157109,46454,39166,203563
104,0500000US09013,"Tolland County, Connecticut",135541,86763,23256,18019,110019
105,0500000US09015,"Windham County, Connecticut",111707,71128,18135,19269,89263
106,0500000US10001,"Kent County, Delaware",172411,103819,29034,40891,132853
107,0500000US10003,"New Castle County, Delaware",542628,339609,85126,94368,424735
108,0500000US10005,"Sussex County, Delaware",225747,121619,62727,44594,184346
109,0500000US11001,"District of Columbia, District of Columbia",669031,459981,83460,149547,543441
110,0500000US12001,"Alachua County, Florida",257170,171722,36991,67936,208713
111,0500000US12005,"Bay County, Florida",183220,113476,30167,38241,143643
112,0500000US12009,"Brevard County, Florida",590143,342098,139332,115810,481430
113,0500000US12011,"Broward County, Florida",1935744,1207097,320063,393459,1527160
114,0500000US12015,"Charlotte County, Florida",181377,86157,73303,36592,159460
115,0500000US12017,"Citrus County, Florida",145414,70707,53286,38873,123993
116,0500000US12019,"Clay County, Florida",213559,130390,34267,44616,164657
117,0500000US12021,"Collier County, Florida",374902,189899,121833,73859,311732
118,0500000US12023,"Columbia County, Florida",65554,38221,12324,17910,50545
119,0500000US12031,"Duval County, Florida",928973,586586,130209,225356,716795
120,0500000US12033,"Escambia County, Florida",297104,182151,51089,67045,233240
121,0500000US12035,"Flagler County, Florida",111079,57357,35109,19018,92466
122,0500000US12053,"Hernando County, Florida",188642,101920,52033,50723,153953
123,0500000US12055,"Highlands County, Florida",104015,49290,36582,33104,85872
124,0500000US12057,"Hillsborough County, Florida",1416105,894852,203319,336424,1098171
125,0500000US12061,"Indian River County, Florida",156228,80383,50928,30471,131311
126,0500000US12069,"Lake County, Florida",352795,190891,94206,79479,285097
127,0500000US12071,"Lee County, Florida",745525,400757,213540,153348,614297
128,0500000US12073,"Leon County, Florida",279466,188238,38054,81469,226292
129,0500000US12081,"Manatee County, Florida",390298,212894,106514,77097,319408
130,0500000US12083,"Marion County, Florida",348888,182650,102695,90554,285345
131,0500000US12085,"Martin County, Florida",157847,81787,49662,26479,131449
132,0500000US12086,"Miami-Dade County, Florida",2724358,1729901,440941,777539,2170842
133,0500000US12087,"Monroe County, Florida",73690,45765,16819,13948,62584
134,0500000US12089,"Nassau County, Florida",85278,49591,18599,14553,68190
135,0500000US12091,"Okaloosa County, Florida",201214,121716,33700,44928,155416
136,0500000US12095,"Orange County, Florida",1345264,884104,161850,341641,1045954
137,0500000US12097,"Osceola County, Florida",365572,228970,47833,99619,276803
138,0500000US12099,"Palm Beach County, Florida",1464632,835014,350892,313385,1185906
139,0500000US12101,"Pasco County, Florida",529431,302388,120233,110906,422621
140,0500000US12103,"Pinellas County, Florida",960680,568442,236625,194007,805067
141,0500000US12105,"Polk County, Florida",694899,399411,141922,183772,541333
142,0500000US12107,"Putnam County, Florida",73072,40396,17104,22897,57500
143,0500000US12109,"St. Johns County, Florida",252317,146620,51348,33786,197968
144,0500000US12111,"St. Lucie County, Florida",318115,179727,76419,75073,256146
145,0500000US12113,"Santa Rosa County, Florida",173122,106883,27904,25053,134787
146,0500000US12115,"Sarasota County, Florida",421163,206779,154555,68616,361334
147,0500000US12117,"Seminole County, Florida",463475,294623,71218,73577,365841
148,0500000US12119,"Sumter County, Florida",119252,37748,72439,18174,110187
149,0500000US12127,"Volusia County, Florida",537658,311681,131349,116255,443030
150,0500000US12131,"Walton County, Florida",69591,41323,14302,12281,55625
151,0500000US13013,"Barrow County, Georgia",80449,49605,10121,16622,59726
152,0500000US13015,"Bartow County, Georgia",104791,65650,14440,23254,80090
153,0500000US13021,"Bibb County, Georgia",145375,86256,23101,47938,109357
154,0500000US13031,"Bulloch County, Georgia",68339,45020,8386,22662,53406
155,0500000US13045,"Carroll County, Georgia",113659,70125,16509,30238,86634
156,0500000US13047,"Catoosa County, Georgia",66348,41014,11855,9953,52869
157,0500000US13051,"Chatham County, Georgia",278029,174373,43088,61032,217461
158,0500000US13057,"Cherokee County, Georgia",252281,154686,35884,37067,190570
159,0500000US13059,"Clarke County, Georgia",116178,80174,14640,48365,94814
160,0500000US13063,"Clayton County, Georgia",282949,176957,26465,91759,203422
161,0500000US13067,"Cobb County, Georgia",743993,477451,91501,105868,568952
162,0500000US13073,"Columbia County, Georgia",153891,93648,21161,18631,114809
163,0500000US13077,"Coweta County, Georgia",144690,90056,20610,27440,110666
164,0500000US13089,"DeKalb County, Georgia",742726,476488,92053,173595,568541
165,0500000US13095,"Dougherty County, Georgia",87006,52484,13592,34822,66076
166,0500000US13097,"Douglas County, Georgia",143523,89728,17153,33367,106881
167,0500000US13113,"Fayette County, Georgia",112378,66587,20092,9302,86679
168,0500000US13115,"Floyd County, Georgia",93320,55749,15897,34076,71646
169,0500000US13117,"Forsyth County, Georgia",235749,143074,28172,18506,171246
170,0500000US13121,"Fulton County, Georgia",1017969,671012,120437,211157,791449
171,0500000US13127,"Glynn County, Georgia",83329,48995,16510,20269,65505
172,0500000US13135,"Gwinnett County, Georgia",922124,582708,92414,160337,675122
173,0500000US13139,"Hall County, Georgia",200254,119878,29623,44748,149501
174,0500000US13151,"Henry County, Georgia",228354,144066,26076,32105,170142
175,0500000US13153,"Houston County, Georgia",152841,97228,17856,30814,115084
176,0500000US13157,"Jackson County, Georgia",69412,41867,10032,10582,51899
177,0500000US13185,"Lowndes County, Georgia",111327,70118,14264,44983,84382
178,0500000US13215,"Muscogee County, Georgia",187584,114527,25614,58192,140141
179,0500000US13217,"Newton County, Georgia",108135,65733,14169,26666,79902
180,0500000US13223,"Paulding County, Georgia",162820,102982,16735,22725,119717
181,0500000US13245,"Richmond County, Georgia",190976,119816,26712,67068,146528
182,0500000US13247,"Rockdale County, Georgia",89356,54977,12577,19196,67554
183,0500000US13255,"Spalding County, Georgia",64668,37311,11821,18261,49132
184,0500000US13285,"Troup County, Georgia",68298,41817,9715,22723,51532
185,0500000US13295,"Walker County, Georgia",67780,40042,12754,19033,52796
186,0500000US13297,"Walton County, Georgia",92277,55575,13702,19192,69277
187,0500000US13313,"Whitfield County, Georgia",102783,61102,14378,27327,75480
188,0500000US15001,"Hawaii County, Hawaii",198192,113019,42425,46391,155444
189,0500000US15003,"Honolulu County, Hawaii",947926,574176,170172,123769,744348
190,0500000US15007,"Kauai County, Hawaii",71341,41342,14423,12337,55765
191,0500000US15009,"Maui County, Hawaii",164915,99333,30236,21137,129569
192,0500000US16001,"Ada County, Idaho",460116,283856,66322,76385,350178
193,0500000US16005,"Bannock County, Idaho",85289,50612,12154,22824,62766
194,0500000US16019,"Bonneville County, Idaho",115829,65175,14833,23521,80008
195,0500000US16027,"Canyon County, Idaho",219912,126998,31454,51446,158452
196,0500000US16055,"Kootenai County, Idaho",159779,93746,29904,33611,123650
197,0500000US16083,"Twin Falls County, Idaho",85040,48871,12685,19160,61556
198,0500000US17001,"Adams County, Illinois",64368,37071,12442,13217,49513
199,0500000US17019,"Champaign County, Illinois",194474,130535,25460,55796,155995
200,0500000US17031,"Cook County, Illinois",5095522,3240161,735788,1121261,3975949
201,0500000US17037,"DeKalb County, Illinois",99303,64688,12761,19468,77449
202,0500000US17043,"DuPage County, Illinois",914854,567041,139425,101105,706466
203,0500000US17089,"Kane County, Illinois",527933,322981,71526,85785,394507
204,0500000US17091,"Kankakee County, Illinois",105667,63317,17544,28423,80861
205,0500000US17093,"Kendall County, Illinois",127569,77907,13330,6632,91237
206,0500000US17097,"Lake County, Illinois",682760,418414,96853,100408,515267
207,0500000US17099,"LaSalle County, Illinois",106189,63295,19752,22224,83047
208,0500000US17111,"McHenry County, Illinois",306266,190795,44047,27851,234842
209,0500000US17113,"McLean County, Illinois",164375,105725,21971,34605,127696
210,0500000US17115,"Macon County, Illinois",101448,58315,20180,25510,78495
211,0500000US17119,"Madison County, Illinois",258426,157977,44415,56397,202392
212,0500000US17143,"Peoria County, Illinois",175616,104899,28925,44954,133824
213,0500000US17161,"Rock Island County, Illinois",138642,80884,25951,32932,106835
214,0500000US17163,"St. Clair County, Illinois",256652,157126,39779,56097,196905
215,0500000US17167,"Sangamon County, Illinois",190831,114985,34120,41672,149105
216,0500000US17179,"Tazewell County, Illinois",129593,76060,24205,23012,100265
217,0500000US17183,"Vermilion County, Illinois",73670,41556,14678,21773,56234
218,0500000US17197,"Will County, Illinois",682218,423723,88533,82338,512256
219,0500000US17199,"Williamson County, Illinois",64571,38002,12193,18624,50195
220,0500000US17201,"Winnebago County, Illinois",278842,166662,47890,73042,214552
221,0500000US18003,"Allen County, Indiana",368922,221563,52945,86476,274508
222,0500000US18005,"Bartholomew County, Indiana",81615,49204,12999,12960,62203
223,0500000US18011,"Boone County, Indiana",66249,40311,8432,5524,48743
224,0500000US18019,"Clark County, Indiana",115294,71506,18309,21443,89815
225,0500000US18035,"Delaware County, Indiana",107717,67863,18784,35931,86647
226,0500000US18039,"Elkhart County, Indiana",201449,117406,28731,42049,146137
227,0500000US18043,"Floyd County, Indiana",76148,47195,11688,10999,58883
228,0500000US18053,"Grant County, Indiana",60382,34599,12189,16660,46788
229,0500000US18057,"Hamilton County, Indiana",328461,199060,40647,26804,239707
230,0500000US18059,"Hancock County, Indiana",75021,45397,12591,9285,57988
231,0500000US18063,"Hendricks County, Indiana",164227,100848,22372,14732,123220
232,0500000US18067,"Howard County, Indiana",80684,47202,15499,14127,62701
233,0500000US18081,"Johnson County, Indiana",153314,92904,21893,20540,114797
234,0500000US18085,"Kosciusko County, Indiana",77435,46327,12668,13963,58995
235,0500000US18089,"Lake County, Indiana",478813,289420,77860,117533,367280
236,0500000US18091,"LaPorte County, Indiana",102117,59713,19403,28134,79116
237,0500000US18095,"Madison County, Indiana",123260,73333,22775,33034,96108
238,0500000US18097,"Marion County, Indiana",933668,590016,116260,260150,706276
239,0500000US18105,"Monroe County, Indiana",131510,90657,18437,39411,109094
240,0500000US18109,"Morgan County, Indiana",68993,41653,11288,9894,52941
241,0500000US18127,"Porter County, Indiana",165570,102030,26332,23409,128362
242,0500000US18141,"St. Joseph County, Indiana",258884,153168,42003,60167,195171
243,0500000US18157,"Tippecanoe County, Indiana",176849,115914,21513,52058,137427
244,0500000US18163,"Vanderburgh County, Indiana",174506,107209,28712,44247,135921
245,0500000US18167,"Vigo County, Indiana",98726,62097,16280,28498,78377
246,0500000US18177,"Wayne County, Indiana",62823,37308,11781,17315,49089
247,0500000US19013,"Black Hawk County, Iowa",127354,78627,20660,34212,99287
248,0500000US19049,"Dallas County, Iowa",89591,53802,10366,9757,64168
249,0500000US19061,"Dubuque County, Iowa",93086,55139,16882,19753,72021
250,0500000US19103,"Johnson County, Iowa",143968,96806,17115,36873,113921
251,0500000US19113,"Linn County, Iowa",220675,133258,35811,35827,169069
252,0500000US19153,"Polk County, Iowa",477975,297550,61167,84210,358717
253,0500000US19155,"Pottawattamie County, Iowa",91092,53849,16103,19609,69952
254,0500000US19163,"Scott County, Iowa",169603,102462,26729,30182,129191
255,0500000US19169,"Story County, Iowa",86645,59436,11241,22406,70677
256,0500000US19193,"Woodbury County, Iowa",99863,58184,15382,23468,73566
257,0500000US20015,"Butler County, Kansas",63783,37355,9698,10550,47053
258,0500000US20045,"Douglas County, Kansas",113654,77125,14930,26983,92055
259,0500000US20091,"Johnson County, Kansas",590890,364002,83946,57829,447948
260,0500000US20103,"Leavenworth County, Kansas",75689,44642,11614,13657,56256
261,0500000US20161,"Riley County, Kansas",63368,45317,6682,22624,51999
262,0500000US20173,"Sedgwick County, Kansas",506817,304449,72550,117267,376999
263,0500000US20177,"Shawnee County, Kansas",172811,100539,31498,38896,132037
264,0500000US20209,"Wyandotte County, Kansas",163023,98194,19946,54023,118140
265,0500000US21015,"Boone County, Kentucky",129864,79983,17076,13447,97059
266,0500000US21029,"Bullitt County, Kentucky",79894,50411,13021,15417,63432
267,0500000US21037,"Campbell County, Kentucky",89418,55912,14408,19125,70320
268,0500000US21047,"Christian County, Kentucky",64280,37362,8314,21730,45676
269,0500000US21059,"Daviess County, Kentucky",98628,57573,16545,26975,74118
270,0500000US21067,"Fayette County, Kentucky",310981,203017,41963,68903,244980
271,0500000US21093,"Hardin County, Kentucky",106895,65268,15509,25484,80777
272,0500000US21111,"Jefferson County, Kentucky",751545,465779,120828,177260,586607
273,0500000US21117,"Kenton County, Kentucky",163327,101493,23455,30130,124948
274,0500000US21145,"McCracken County, Kentucky",63718,36984,12940,14801,49924
275,0500000US21151,"Madison County, Kentucky",86301,55771,12331,21493,68102
276,0500000US21185,"Oldham County, Kentucky",63086,37777,8314,6309,46091
277,0500000US21227,"Warren County, Kentucky",122943,77397,16743,34245,94140
278,0500000US22005,"Ascension Parish, Louisiana",123465,76615,13995,21269,90610
279,0500000US22015,"Bossier Parish, Louisiana",125524,76906,17028,33960,93934
280,0500000US22017,"Caddo Parish, Louisiana",237840,141799,39446,80488,181245
281,0500000US22019,"Calcasieu Parish, Louisiana",200157,120370,29702,50645,150072
282,0500000US22033,"East Baton Rouge Parish, Louisiana",431849,271114,61472,116182,332586
283,0500000US22045,"Iberia Parish, Louisiana",69861,41920,10142,23452,52062
284,0500000US22051,"Jefferson Parish, Louisiana",430094,263214,72691,113571,335905
285,0500000US22055,"Lafayette Parish, Louisiana",237706,149670,30949,55823,180619
286,0500000US22057,"Lafourche Parish, Louisiana",96289,58264,15161,25949,73425
287,0500000US22063,"Livingston Parish, Louisiana",137806,84331,18611,24419,102942
288,0500000US22071,"Orleans Parish, Louisiana",374022,241187,56246,136064,297433
289,0500000US22073,"Ouachita Parish, Louisiana",147023,86440,22059,47950,108499
290,0500000US22079,"Rapides Parish, Louisiana",126219,75269,20226,36038,95495
291,0500000US22097,"St. Landry Parish, Louisiana",81349,46945,12539,36359,59484
292,0500000US22103,"St. Tammany Parish, Louisiana",255974,151404,43078,54125,194482
293,0500000US22105,"Tangipahoa Parish, Louisiana",130144,79173,18525,41457,97698
294,0500000US22109,"Terrebonne Parish, Louisiana",109489,65504,16224,26273,81728
295,0500000US23001,"Androscoggin County, Maine",104252,64325,18360,22865,82685
296,0500000US23003,"Aroostook County, Maine",65029,37985,15320,19833,53305
297,0500000US23005,"Cumberland County, Maine",286082,180046,52385,35852,232431
298,0500000US23011,"Kennebec County, Maine",118601,72224,23756,24255,95980
299,0500000US23019,"Penobscot County, Maine",144946,92126,26777,34255,118903
300,0500000US23031,"York County, Maine",201870,123629,41569,29948,165198
301,0500000US24001,"Allegany County, Maryland",62081,37047,13259,17541,50306
302,0500000US24003,"Anne Arundel County, Maryland",559510,349526,83234,60246,432760
303,0500000US24005,"Baltimore County, Maryland",808289,495209,137895,123742,633104
304,0500000US24009,"Calvert County, Maryland",91250,56956,13324,6762,70280
305,0500000US24013,"Carroll County, Maryland",165024,102010,26663,17669,128673
306,0500000US24015,"Cecil County, Maryland",101507,62919,15912,17334,78831
307,0500000US24017,"Charles County, Maryland",159465,101881,19667,15714,121548
308,0500000US24021,"Frederick County, Maryland",250708,156405,36053,27243,192458
309,0500000US24025,"Harford County, Maryland",252208,155134,41383,29184,196517
310,0500000US24027,"Howard County, Maryland",320987,198659,44250,28115,242909
311,0500000US24031,"Montgomery County, Maryland",1042883,642419,159700,126371,802119
312,0500000US24033,"Prince George's County, Maryland",887311,571817,118135,124128,689952
313,0500000US24037,"St. Mary's County, Maryland",109795,68445,14360,14769,82805
314,0500000US24043,"Washington County, Maryland",141861,84000,25439,28246,109439
315,0500000US24045,"Wicomico County, Maryland",99407,60856,15909,23932,76765
316,0500000US24510,"Baltimore city, Maryland",580628,378132,81609,166236,459741
317,0500000US25001,"Barnstable County, Massachusetts",210328,114960,64069,28838,179029
318,0500000US25003,"Berkshire County, Massachusetts",119676,71050,28280,20398,99330
319,0500000US25005,"Bristol County, Massachusetts",549525,343529,91828,99020,435357
320,0500000US25009,"Essex County, Massachusetts",774049,477108,130763,130429,607871
321,0500000US25011,"Franklin County, Massachusetts",69379,42325,15030,12301,57355
322,0500000US25013,"Hampden County, Massachusetts",456515,280787,75945,121109,356732
323,0500000US25015,"Hampshire County, Massachusetts",138177,87759,27424,22482,115183
324,0500000US25017,"Middlesex County, Massachusetts",1560058,1004705,239621,182691,1244326
325,0500000US25021,"Norfolk County, Massachusetts",685819,425533,115145,69382,540678
326,0500000US25023,"Plymouth County, Massachusetts",505958,307222,90476,53926,397698
327,0500000US25025,"Suffolk County, Massachusetts",763888,538499,94343,191153,632842
328,0500000US25027,"Worcester County, Massachusetts",803261,506878,124906,121332,631784
329,0500000US26005,"Allegan County, Michigan",115591,68891,19103,23137,87994
330,0500000US26017,"Bay County, Michigan",102858,61778,20205,23992,81983
331,0500000US26021,"Berrien County, Michigan",151150,88628,29892,41414,118520
332,0500000US26025,"Calhoun County, Michigan",130678,77676,23207,34405,100883
333,0500000US26037,"Clinton County, Michigan",78372,47627,13479,11406,61106
334,0500000US26045,"Eaton County, Michigan",107667,65945,19937,15768,85882
335,0500000US26049,"Genesee County, Michigan",402235,242243,70162,113210,312405
336,0500000US26055,"Grand Traverse County, Michigan",90733,54687,17971,16718,72658
337,0500000US26065,"Ingham County, Michigan",273994,178151,39227,75467,217378
338,0500000US26073,"Isabella County, Michigan",64251,43880,8837,22389,52717
339,0500000US26075,"Jackson County, Michigan",148980,88501,27648,35043,116149
340,0500000US26077,"Kalamazoo County, Michigan",256825,161411,39084,58089,200495
341,0500000US26081,"Kent County, Michigan",643308,400608,87333,128893,487941
342,0500000US26087,"Lapeer County, Michigan",86003,52730,15535,15508,68265
343,0500000US26091,"Lenawee County, Michigan",93503,55597,17543,17931,73140
344,0500000US26093,"Livingston County, Michigan",189141,116650,32723,15460,149373
345,0500000US26099,"Macomb County, Michigan",866227,538948,145690,160034,684638
346,0500000US26103,"Marquette County, Michigan",63146,38822,12361,14561,51183
347,0500000US26111,"Midland County, Michigan",81952,48706,15233,17248,63939
348,0500000US26115,"Monroe County, Michigan",149045,90464,27021,26098,117485
349,0500000US26121,"Muskegon County, Michigan",165624,98917,28454,45816,127371
350,0500000US26125,"Oakland County, Michigan",1248637,778302,208079,165066,986381
351,0500000US26139,"Ottawa County, Michigan",280965,169874,42616,34310,212490
352,0500000US26145,"Saginaw County, Michigan",184490,109171,35710,46247,144881
353,0500000US26147,"St. Clair County, Michigan",156928,95607,29347,34408,124954
354,0500000US26155,"Shiawassee County, Michigan",67205,40663,12315,12374,52978
355,0500000US26159,"Van Buren County, Michigan",74544,43851,13746,16508,57597
356,0500000US26161,"Washtenaw County, Michigan",351671,233047,50706,76213,283753
357,0500000US26163,"Wayne County, Michigan",1733848,1061032,263878,548437,1324910
358,0500000US27003,"Anoka County, Minnesota",350619,218345,48984,34467,267329
359,0500000US27013,"Blue Earth County, Minnesota",64231,42046,8929,17719,50975
360,0500000US27019,"Carver County, Minnesota",102743,62567,12521,5937,75088
361,0500000US27037,"Dakota County, Minnesota",422300,262231,58083,45060,320314
362,0500000US27053,"Hennepin County, Minnesota",1238710,794587,171521,204629,966108
363,0500000US27109,"Olmsted County, Minnesota",154128,92971,23321,20748,116292
364,0500000US27123,"Ramsey County, Minnesota",535746,333204,76691,114515,409895
365,0500000US27131,"Rice County, Minnesota",58161,33695,9882,10557,43577
366,0500000US27137,"St. Louis County, Minnesota",191821,118247,36832,43828,155079
367,0500000US27139,"Scott County, Minnesota",145061,90149,15526,15187,105675
368,0500000US27141,"Sherburne County, Minnesota",93818,58602,10213,11403,68815
369,0500000US27145,"Stearns County, Minnesota",152934,93262,23193,35293,116455
370,0500000US27163,"Washington County, Minnesota",255266,154534,38069,20306,192603
371,0500000US27171,"Wright County, Minnesota",134110,80926,16814,11545,97740
372,0500000US28033,"DeSoto County, Mississippi",179872,111805,22742,27753,134547
373,0500000US28035,"Forrest County, Mississippi",71314,43838,10066,29263,53904
374,0500000US28047,"Harrison County, Mississippi",201203,121978,30294,61850,152272
375,0500000US28049,"Hinds County, Mississippi",227876,139657,32728,72121,172385
376,0500000US28059,"Jackson County, Mississippi",142048,86190,22353,39996,108543
377,0500000US28067,"Jones County, Mississippi",66816,38409,11506,16820,49915
378,0500000US28075,"Lauderdale County, Mississippi",72141,41935,12592,28088,54527
379,0500000US28081,"Lee County, Mississippi",84293,52118,11498,18486,63616
380,0500000US28089,"Madison County, Mississippi",104067,64127,13585,13768,77712
381,0500000US28121,"Rankin County, Mississippi",148000,90206,22350,22144,112556
382,0500000US29019,"Boone County, Missouri",170672,114225,21166,42232,135391
383,0500000US29021,"Buchanan County, Missouri",84848,51118,14438,23030,65556
384,0500000US29031,"Cape Girardeau County, Missouri",75547,46474,12347,18555,58821
385,0500000US29037,"Cass County, Missouri",103702,61523,17524,12662,79047
386,0500000US29043,"Christian County, Missouri",85362,50262,13171,15900,63433
387,0500000US29047,"Clay County, Missouri",243374,150660,34126,35309,184786
388,0500000US29051,"Cole County, Missouri",72113,42701,12387,10298,55088
389,0500000US29071,"Franklin County, Missouri",102304,61381,17628,16301,79009
390,0500000US29077,"Greene County, Missouri",279887,173981,46788,77210,220769
391,0500000US29095,"Jackson County, Missouri",687991,425276,101152,152960,526428
392,0500000US29097,"Jasper County, Missouri",118336,70445,18342,35523,88787
393,0500000US29099,"Jefferson County, Missouri",221639,138194,32772,28712,170966
394,0500000US29165,"Platte County, Missouri",102388,63237,14909,12532,78146
395,0500000US29183,"St. Charles County, Missouri",391214,241003,58425,38850,299428
396,0500000US29187,"St. Francois County, Missouri",59266,35732,10274,14737,46006
397,0500000US29189,"St. Louis County, Missouri",976829,586578,173608,161867,760186
398,0500000US29510,"St. Louis city, Missouri",294353,197303,40453,95782,237756
399,0500000US30013,"Cascade County, Montana",79634,47418,14603,18659,62021
400,0500000US30029,"Flathead County, Montana",101399,59433,19587,25954,79020
401,0500000US30031,"Gallatin County, Montana",108058,71226,14225,19422,85451
402,0500000US30049,"Lewis and Clark County, Montana",67181,40008,12414,11231,52422
403,0500000US30063,"Missoula County, Montana",115701,76196,18035,22662,94231
404,0500000US30111,"Yellowstone County, Montana",157012,93557,26314,28938,119871
405,0500000US31055,"Douglas County, Nebraska",553663,339860,71525,102844,411385
406,0500000US31109,"Lancaster County, Nebraska",303520,189444,43549,62521,232993
407,0500000US31153,"Sarpy County, Nebraska",182891,111284,21553,21682,132837
408,0500000US32003,"Clark County, Nevada",2205026,1369952,326001,519656,1695953
409,0500000US32031,"Washoe County, Nevada",459808,285144,75629,80143,360773
410,0500000US33005,"Cheshire County, New Hampshire",71902,43785,14661,13645,58446
411,0500000US33009,"Grafton County, New Hampshire",83453,51518,17951,12495,69469
412,0500000US33011,"Hillsborough County, New Hampshire",406805,261662,61990,52160,323652
413,0500000US33013,"Merrimack County, New Hampshire",144478,88903,27496,16141,116399
414,0500000US33015,"Rockingham County, New Hampshire",306113,192747,54162,27906,246909
415,0500000US33017,"Strafford County, New Hampshire",119753,77886,18778,18910,96664
416,0500000US34001,"Atlantic County, New Jersey",259787,158336,46041,56089,204377
417,0500000US34003,"Bergen County, New Jersey",927422,572115,157334,101835,729449
418,0500000US34005,"Burlington County, New Jersey",433361,268830,73108,47573,341938
419,0500000US34007,"Camden County, New Jersey",500064,310472,76640,107414,387112
420,0500000US34009,"Cape May County, New Jersey",90737,52833,23214,15722,76047
421,0500000US34011,"Cumberland County, New Jersey",139439,82404,22133,39814,104537
422,0500000US34013,"Essex County, New Jersey",779167,488321,104561,184871,592882
423,0500000US34015,"Gloucester County, New Jersey",287445,178869,45911,33986,224780
424,0500000US34017,"Hudson County, New Jersey",668092,453038,78050,153238,531088
425,0500000US34019,"Hunterdon County, New Jersey",120990,74446,23033,11207,97479
426,0500000US34021,"Mercer County, New Jersey",355087,222696,54104,60968,276800
427,0500000US34023,"Middlesex County, New Jersey",800115,499523,121681,106492,621204
428,0500000US34025,"Monmouth County, New Jersey",615667,377950,107072,64534,485022
429,0500000US34027,"Morris County, New Jersey",485909,301426,81696,36312,383122
430,0500000US34029,"Ocean County, New Jersey",594629,318835,133436,98019,452271
431,0500000US34031,"Passaic County, New Jersey",496838,306432,71233,111304,377665
432,0500000US34033,"Salem County, New Jersey",61071,36709,11232,13850,47941
433,0500000US34035,"Somerset County, New Jersey",327508,206052,50057,25061,256109
434,0500000US34037,"Sussex County, New Jersey",139077,88502,23066,11927,111568
435,0500000US34039,"Union County, New Jersey",552604,344461,78443,80531,422904
436,0500000US34041,"Warren County, New Jersey",104295,64886,18727,11331,83613
437,0500000US35001,"Bernalillo County, New Mexico",669362,415526,109679,179882,525205
438,0500000US35005,"Chaves County, New Mexico",62731,36008,10561,20065,46569
439,0500000US35013,"Doña Ana County, New Mexico",211752,125751,34404,84928,160155
440,0500000US35025,"Lea County, New Mexico",66912,38817,7619,19556,46436
441,0500000US35031,"McKinley County, New Mexico",71818,41919,9145,35966,51064
442,0500000US35035,"Otero County, New Mexico",62765,36996,10430,18002,47426
443,0500000US35043,"Sandoval County, New Mexico",142955,85326,25553,30607,110879
444,0500000US35045,"San Juan County, New Mexico",122966,72002,18785,44714,90787
445,0500000US35049,"Santa Fe County, New Mexico",147907,84914,36387,33699,121301
446,0500000US35061,"Valencia County, New Mexico",74664,43597,13590,21768,57187
447,0500000US36001,"Albany County, New York",291334,185989,49660,51671,235649
448,0500000US36005,"Bronx County, New York",1397994,876190,173807,553216,1049997
449,0500000US36007,"Broome County, New York",182604,110932,35463,47851,146395
450,0500000US36009,"Cattaraugus County, New York",74631,43905,14300,20375,58205
451,0500000US36011,"Cayuga County, New York",72303,44054,13839,15723,57893
452,0500000US36013,"Chautauqua County, New York",122676,72916,24717,34536,97633
453,0500000US36015,"Chemung County, New York",79831,47003,16048,16901,63051
454,0500000US36019,"Clinton County, New York",72955,45757,13078,15426,58835
455,0500000US36027,"Dutchess County, New York",278143,174141,49788,40994,223929
456,0500000US36029,"Erie County, New York",892360,549809,160227,196872,710036
457,0500000US36045,"Jefferson County, New York",105475,64332,15088,21474,79420
458,0500000US36047,"Kings County, New York",2557510,1624516,350530,732305,1975046
459,0500000US36051,"Livingston County, New York",56798,35056,10808,10807,45864
460,0500000US36053,"Madison County, New York",65324,39265,12778,11977,52043
461,0500000US36055,"Monroe County, New York",716791,442616,123273,167373,565889
462,0500000US36059,"Nassau County, New York",1339196,815302,235450,126657,1050752
463,0500000US36061,"New York County, New York",1582510,1089070,262955,353687,1352025
464,0500000US36063,"Niagara County, New York",207113,126791,38575,44516,165366
465,0500000US36065,"Oneida County, New York",217729,129849,39999,56486,169848
466,0500000US36067,"Onondaga County, New York",443189,269886,76540,93830,346426
467,0500000US36069,"Ontario County, New York",106661,63442,21181,16025,84623
468,0500000US36071,"Orange County, New York",370730,224492,51898,69980,276390
469,0500000US36075,"Oswego County, New York",112985,69879,19211,29349,89090
470,0500000US36079,"Putnam County, New York",97616,61358,16882,8928,78240
471,0500000US36081,"Queens County, New York",2250553,1454955,346823,460398,1801778
472,0500000US36083,"Rensselaer County, New York",153954,97578,25563,26417,123141
473,0500000US36085,"Richmond County, New York",469457,292790,74695,79736,367485
474,0500000US36087,"Rockland County, New York",321255,180596,49943,73827,230539
475,0500000US36089,"St. Lawrence County, New York",96405,57929,17579,23512,75508
476,0500000US36091,"Saratoga County, New York",226659,140453,40299,23659,180752
477,0500000US36093,"Schenectady County, New York",151328,92609,25906,28788,118515
478,0500000US36101,"Steuben County, New York",94221,56446,17873,20710,74319
479,0500000US36103,"Suffolk County, New York",1457692,905180,244295,165634,1149475
480,0500000US36105,"Sullivan County, New York",73664,44079,13749,20673,57828
481,0500000US36109,"Tompkins County, New York",89058,60445,13830,21912,74275
482,0500000US36111,"Ulster County, New York",170477,105805,34493,38228,140298
483,0500000US36113,"Warren County, New York",63494,38282,14007,11655,52289
484,0500000US36117,"Wayne County, New York",89116,53152,16831,14903,69983
485,0500000US36119,"Westchester County, New York",943875,576139,159880,132187,736019
486,0500000US37001,"Alamance County, North Carolina",161866,97954,27562,40980,125516
487,0500000US37019,"Brunswick County, North Carolina",135905,71842,43175,22951,115017
488,0500000US37021,"Buncombe County, North Carolina",252525,156114,49685,53183,205799
489,0500000US37023,"Burke County, North Carolina",87656,53722,17580,24615,71302
490,0500000US37025,"Cabarrus County, North Carolina",208579,128387,27435,34391,155822
491,0500000US37027,"Caldwell County, North Carolina",81140,48991,15763,26178,64754
492,0500000US37031,"Carteret County, North Carolina",67574,39024,17162,9946,56186
493,0500000US37035,"Catawba County, North Carolina",155628,93798,27571,38049,121369
494,0500000US37037,"Chatham County, North Carolina",72501,40109,17542,12061,57651
495,0500000US37045,"Cleveland County, North Carolina",95702,56673,17931,30952,74604
496,0500000US37049,"Craven County, North Carolina",97743,56095,19181,24527,75276
497,0500000US37051,"Cumberland County, North Carolina",316943,196231,39574,89332,235805
498,0500000US37057,"Davidson County, North Carolina",164548,99186,29236,46975,128422
499,0500000US37063,"Durham County, North Carolina",302710,197388,40583,62631,237971
500,0500000US37067,"Forsyth County, North Carolina",368351,222922,59581,99047,282503
501,0500000US37069,"Franklin County, North Carolina",65886,40164,11396,12912,51560
502,0500000US37071,"Gaston County, North Carolina",219271,135786,34388,52719,170174
503,0500000US37081,"Guilford County, North Carolina",514062,319134,78344,130731,397478
504,0500000US37085,"Harnett County, North Carolina",130513,79832,16524,34609,96356
505,0500000US37089,"Henderson County, North Carolina",114872,64111,29458,19782,93569
506,0500000US37097,"Iredell County, North Carolina",176646,108934,27497,30461,136431
507,0500000US37101,"Johnston County, North Carolina",200764,122748,26886,42348,149634
508,0500000US37109,"Lincoln County, North Carolina",82783,51532,13982,12806,65514
509,0500000US37119,"Mecklenburg County, North Carolina",1077563,703177,120585,201526,823762
510,0500000US37125,"Moore County, North Carolina",97627,54165,22636,16274,76801
511,0500000US37127,"Nash County, North Carolina",92017,54896,17064,21167,71960
512,0500000US37129,"New Hanover County, North Carolina",225559,143566,40497,50281,184063
513,0500000US37133,"Onslow County, North Carolina",177272,111481,17824,41930,129305
514,0500000US37135,"Orange County, North Carolina",134444,85173,20578,26259,105751
515,0500000US37147,"Pitt County, North Carolina",172388,112152,23014,59398,135166
516,0500000US37151,"Randolph County, North Carolina",141597,85500,24528,35269,110028
517,0500000US37155,"Robeson County, North Carolina",127513,75961,19293,50512,95254
518,0500000US37157,"Rockingham County, North Carolina",89124,53290,18052,25706,71342
519,0500000US37159,"Rowan County, North Carolina",136456,82559,23419,41608,105978
520,0500000US37161,"Rutherford County, North Carolina",65270,38465,13514,20365,51979
521,0500000US37171,"Surry County, North Carolina",71168,41526,14513,19670,56039
522,0500000US37179,"Union County, North Carolina",233094,140967,29185,31578,170152
523,0500000US37183,"Wake County, North Carolina",1071013,687307,124744,155304,812051
524,0500000US37191,"Wayne County, North Carolina",119577,71336,20230,41227,91566
525,0500000US37193,"Wilkes County, North Carolina",67616,39421,14409,20371,53830
526,0500000US37195,"Wilson County, North Carolina",79823,47255,14298,28445,61553
527,0500000US38015,"Burleigh County, North Dakota",92425,56244,14552,11206,70796
528,0500000US38017,"Cass County, North Dakota",176674,115537,20868,34781,136405
529,0500000US38035,"Grand Forks County, North Dakota",66502,43406,8429,15040,51835
530,0500000US38101,"Ward County, North Dakota",65750,42005,8078,10887,50083
531,0500000US39003,"Allen County, Ohio",98896,58897,17325,23172,76222
532,0500000US39007,"Ashtabula County, Ohio",94220,55437,17778,29795,73215
533,0500000US39009,"Athens County, Ohio",56162,38306,8408,22506,46714
534,0500000US39013,"Belmont County, Ohio",63700,37090,13473,13601,50563
535,0500000US39017,"Butler County, Ohio",369812,227492,54439,75743,281931
536,0500000US39023,"Clark County, Ohio",130902,76759,24990,30963,101749
537,0500000US39025,"Clermont County, Ohio",203539,124265,32286,32374,156551
538,0500000US39029,"Columbiana County, Ohio",98445,58162,19967,24768,78129
539,0500000US39035,"Cuyahoga County, Ohio",1218045,744854,218680,321768,963534
540,0500000US39041,"Delaware County, Ohio",202056,121275,27208,14474,148483
541,0500000US39043,"Erie County, Ohio",73515,42981,15625,14713,58606
542,0500000US39045,"Fairfield County, Ohio",152342,91917,23796,27780,115713
543,0500000US39049,"Franklin County, Ohio",1281150,825515,154426,304474,979941
544,0500000US39055,"Geauga County, Ohio",92689,53101,18854,11380,71955
545,0500000US39057,"Greene County, Ohio",157475,95733,28585,28917,124318
546,0500000US39061,"Hamilton County, Ohio",798445,495406,119498,182922,614904
547,0500000US39063,"Hancock County, Ohio",73874,44932,12319,12766,57251
548,0500000US39081,"Jefferson County, Ohio",63448,37308,13969,18783,51277
549,0500000US39085,"Lake County, Ohio",227639,136597,45227,29036,181824
550,0500000US39089,"Licking County, Ohio",170948,102957,28279,28019,131236
551,0500000US39093,"Lorain County, Ohio",299836,177921,55155,61440,233076
552,0500000US39095,"Lucas County, Ohio",421106,256518,67644,124489,324162
553,0500000US39099,"Mahoning County, Ohio",222481,131873,45804,57475,177677
554,0500000US39101,"Marion County, Ohio",59723,35198,10833,19070,46031
555,0500000US39103,"Medina County, Ohio",177354,106533,31127,19569,137660
556,0500000US39109,"Miami County, Ohio",105201,60650,19973,14342,80623
557,0500000US39113,"Montgomery County, Ohio",512594,306545,91427,130221,397972
558,0500000US39119,"Muskingum County, Ohio",83477,49939,14663,21702,64602
559,0500000US39133,"Portage County, Ohio",154886,99641,26420,27690,126061
560,0500000US39139,"Richland County, Ohio",114034,65852,22936,27217,88788
561,0500000US39141,"Ross County, Ohio",71409,42526,12815,20923,55341
562,0500000US39145,"Scioto County, Ohio",72072,42902,12824,24334,55726
563,0500000US39151,"Stark County, Ohio",361953,214703,69488,80221,284191
564,0500000US39153,"Summit County, Ohio",532520,325833,94993,103517,420826
565,0500000US39155,"Trumbull County, Ohio",195009,112937,41758,57668,154695
566,0500000US39157,"Tuscarawas County, Ohio",90639,52770,17461,19034,70231
567,0500000US39165,"Warren County, Ohio",223346,135402,32210,20066,167612
568,0500000US39169,"Wayne County, Ohio",111030,63881,20078,18344,83959
569,0500000US39173,"Wood County, Ohio",124371,78877,19276,23629,98153
570,0500000US40017,"Canadian County, Oklahoma",141976,86386,18436,18643,104822
571,0500000US40027,"Cleveland County, Oklahoma",270259,174041,36523,55775,210564
572,0500000US40031,"Comanche County, Oklahoma",110499,68765,14417,27174,83182
573,0500000US40037,"Creek County, Oklahoma",70335,41628,12120,15425,53748
574,0500000US40101,"Muskogee County, Oklahoma",63775,36916,10785,16396,47701
575,0500000US40109,"Oklahoma County, Oklahoma",776306,471314,105615,206171,576929
576,0500000US40119,"Payne County, Oklahoma",73834,46935,10839,22988,57774
577,0500000US40125,"Pottawatomie County, Oklahoma",69751,41256,11509,19579,52765
578,0500000US40131,"Rogers County, Oklahoma",90220,55017,14232,15845,69249
579,0500000US40143,"Tulsa County, Oklahoma",639072,386285,91042,147757,477327
580,0500000US40145,"Wagoner County, Oklahoma",79495,47557,12821,11948,60378
581,0500000US41003,"Benton County, Oregon",86020,57041,14769,20905,71810
582,0500000US41005,"Clackamas County, Oregon",413386,251416,73706,52349,325122
583,0500000US41017,"Deschutes County, Oregon",190981,113769,38500,34225,152269
584,0500000US41019,"Douglas County, Oregon",109055,60680,27683,29461,88363
585,0500000US41029,"Jackson County, Oregon",217151,125027,48078,53490,173105
586,0500000US41033,"Josephine County, Oregon",86480,47348,22816,24686,70164
587,0500000US41035,"Klamath County, Oregon",66546,37657,14517,21029,52174
588,0500000US41039,"Lane County, Oregon",372184,231632,73101,103667,304733
589,0500000US41043,"Linn County, Oregon",124602,74611,24120,30537,98731
590,0500000US41047,"Marion County, Oregon",337005,200914,51988,87898,252902
591,0500000US41051,"Multnomah County, Oregon",798127,540765,106531,163539,647296
592,0500000US41053,"Polk County, Oregon",83296,49558,15038,20497,64596
593,0500000US41059,"Umatilla County, Oregon",72869,41883,11438,20852,53321
594,0500000US41067,"Washington County, Oregon",592955,377781,79327,85482,457108
595,0500000US41071,"Yamhill County, Oregon",102078,60954,17567,22623,78521
596,0500000US42001,"Adams County, Pennsylvania",98508,57877,19859,14161,77736
597,0500000US42003,"Allegheny County, Pennsylvania",1187205,740290,222777,225805,963067
598,0500000US42005,"Armstrong County, Pennsylvania",64573,38391,14009,10807,52400
599,0500000US42007,"Beaver County, Pennsylvania",162376,95797,35131,30505,130928
600,0500000US42011,"Berks County, Pennsylvania",406927,246135,70077,76975,316212
601,0500000US42013,"Blair County, Pennsylvania",119657,71693,24225,26588,95918
602,0500000US42017,"Bucks County, Pennsylvania",619788,379592,114007,57128,493599
603,0500000US42019,"Butler County, Pennsylvania",183131,112310,33856,27573,146166
604,0500000US42021,"Cambria County, Pennsylvania",125244,71801,28827,30433,100628
605,0500000US42025,"Carbon County, Pennsylvania",63118,38352,12878,12829,51230
606,0500000US42027,"Centre County, Pennsylvania",144003,98545,21895,35937,120440
607,0500000US42029,"Chester County, Pennsylvania",508569,308226,83068,58407,391294
608,0500000US42033,"Clearfield County, Pennsylvania",73471,43489,15621,18501,59110
609,0500000US42037,"Columbia County, Pennsylvania",61149,37862,12115,11224,49977
610,0500000US42039,"Crawford County, Pennsylvania",81267,46627,17396,17794,64023
611,0500000US42041,"Cumberland County, Pennsylvania",237934,142416,45085,30177,187501
612,0500000US42043,"Dauphin County, Pennsylvania",271543,165468,45432,62011,210900
613,0500000US42045,"Delaware County, Pennsylvania",543740,332810,88768,75891,421578
614,0500000US42049,"Erie County, Pennsylvania",258937,155404,46909,68223,202313
615,0500000US42051,"Fayette County, Pennsylvania",125689,74968,26973,28106,101941
616,0500000US42055,"Franklin County, Pennsylvania",152630,89618,29250,28706,118868
617,0500000US42063,"Indiana County, Pennsylvania",78088,47397,16417,19588,63814
618,0500000US42069,"Lackawanna County, Pennsylvania",202982,120567,40007,49449,160574
619,0500000US42071,"Lancaster County, Pennsylvania",532563,311272,94362,81678,405634
620,0500000US42073,"Lawrence County, Pennsylvania",84107,49235,18305,23096,67540
621,0500000US42075,"Lebanon County, Pennsylvania",137372,79575,26552,25289,106127
622,0500000US42077,"Lehigh County, Pennsylvania",358431,217279,59548,68877,276827
623,0500000US42079,"Luzerne County, Pennsylvania",305379,184125,60314,72726,244439
624,0500000US42081,"Lycoming County, Pennsylvania",106012,62841,20959,20774,83800
625,0500000US42085,"Mercer County, Pennsylvania",103242,60418,22707,25201,83125
626,0500000US42089,"Monroe County, Pennsylvania",167049,106383,27665,32814,134048
627,0500000US42091,"Montgomery County, Pennsylvania",807165,490730,140949,86087,631679
628,0500000US42095,"Northampton County, Pennsylvania",292879,177405,56178,50334,233583
629,0500000US42097,"Northumberland County, Pennsylvania",87078,50862,18727,20295,69589
630,0500000US42101,"Philadelphia County, Pennsylvania",1538479,993819,209117,543254,1202936
631,0500000US42107,"Schuylkill County, Pennsylvania",134783,79371,27386,29892,106757
632,0500000US42111,"Somerset County, Pennsylvania",68778,40125,15693,14410,55818
633,0500000US42125,"Washington County, Pennsylvania",201690,121650,41140,30133,162790
634,0500000US42129,"Westmoreland County, Pennsylvania",342962,202770,77495,52884,280265
635,0500000US42133,"York County, Pennsylvania",439134,265716,75809,74526,341525
636,0500000US44003,"Kent County, Rhode Island",162558,101978,30046,23319,132024
637,0500000US44005,"Newport County, Rhode Island",78732,47144,18157,10959,65301
638,0500000US44007,"Providence County, Rhode Island",610411,390164,92744,149392,482908
639,0500000US44009,"Washington County, Rhode Island",119796,74600,25534,14685,100134
640,0500000US45003,"Aiken County, South Carolina",166508,98481,32022,45066,130503
641,0500000US45007,"Anderson County, South Carolina",197883,118025,34967,46890,152992
642,0500000US45013,"Beaufort County, South Carolina",183363,97320,51046,33634,148366
643,0500000US45015,"Berkeley County, South Carolina",216935,134261,30476,46410,164737
644,0500000US45019,"Charleston County, South Carolina",394291,249546,65228,88650,314774
645,0500000US45031,"Darlington County, South Carolina",65275,38519,12253,25641,50772
646,0500000US45035,"Dorchester County, South Carolina",158412,97585,22251,29206,119836
647,0500000US45041,"Florence County, South Carolina",134691,80225,22648,40169,102873
648,0500000US45045,"Greenville County, South Carolina",502729,306066,79610,97258,385676
649,0500000US45047,"Greenwood County, South Carolina",68409,40678,12448,20237,53126
650,0500000US45051,"Horry County, South Carolina",337209,194231,82628,78332,276859
651,0500000US45055,"Kershaw County, South Carolina",65158,38549,11720,16996,50269
652,0500000US45057,"Lancaster County, South Carolina",93298,53107,19254,21920,72361
653,0500000US45059,"Laurens County, South Carolina",64490,38622,11802,20841,50424
654,0500000US45063,"Lexington County, South Carolina",291905,178376,45758,63287,224134
655,0500000US45073,"Oconee County, South Carolina",77627,43910,18446,17861,62356
656,0500000US45075,"Orangeburg County, South Carolina",83544,48730,16416,34189,65146
657,0500000US45077,"Pickens County, South Carolina",117941,74787,20404,32433,95191
658,0500000US45079,"Richland County, South Carolina",385031,246513,51595,101712,298108
659,0500000US45083,"Spartanburg County, South Carolina",306356,185615,49265,68334,234880
660,0500000US45085,"Sumter County, South Carolina",103395,61553,16951,35229,78504
661,0500000US45091,"York County, South Carolina",270025,165415,38724,49596,204139
662,0500000US46099,"Minnehaha County, South Dakota",185983,114646,24642,31175,139288
663,0500000US46103,"Pennington County, South Dakota",109008,64130,19949,23199,84079
664,0500000US47001,"Anderson County, Tennessee",75386,44404,14857,23017,59261
665,0500000US47009,"Blount County, Tennessee",129405,75637,26818,25039,102455
666,0500000US47011,"Bradley County, Tennessee",102934,62848,17505,28421,80353
667,0500000US47037,"Davidson County, Tennessee",670599,447102,83150,164764,530252
668,0500000US47059,"Greene County, Tennessee",67042,39857,14228,19149,54085
669,0500000US47065,"Hamilton County, Tennessee",352572,216628,61881,74396,278509
670,0500000US47093,"Knox County, Tennessee",455024,286432,71543,99118,357975
671,0500000US47113,"Madison County, Tennessee",93747,55969,16154,27404,72123
672,0500000US47119,"Maury County, Tennessee",93205,56913,14250,18597,71163
673,0500000US47125,"Montgomery County, Tennessee",201086,129165,18088,47206,147253
674,0500000US47141,"Putnam County, Tennessee",75727,46979,12811,19413,59790
675,0500000US47147,"Robertson County, Tennessee",70022,43268,9945,14268,53213
676,0500000US47149,"Rutherford County, Tennessee",319280,207462,32976,61874,240438
677,0500000US47155,"Sevier County, Tennessee",95582,58114,18890,25086,77004
678,0500000US47157,"Shelby County, Tennessee",919075,564110,124262,284951,688372
679,0500000US47163,"Sullivan County, Tennessee",154553,90545,34381,40290,124926
680,0500000US47165,"Sumner County, Tennessee",184690,113091,28842,29474,141933
681,0500000US47179,"Washington County, Tennessee",123917,77418,22536,32473,99954
682,0500000US47187,"Williamson County, Tennessee",231153,137826,30425,12174,168251
683,0500000US47189,"Wilson County, Tennessee",138547,83524,22044,21702,105568
684,0500000US48005,"Angelina County, Texas",84905,49886,12930,29653,62816
685,0500000US48021,"Bastrop County, Texas",84840,50966,11780,16382,62746
686,0500000US48027,"Bell County, Texas",343548,208254,37560,85469,245814
687,0500000US48029,"Bexar County, Texas",1952157,1215479,235744,534659,1451223
688,0500000US48037,"Bowie County, Texas",88549,51536,14374,24501,65910
689,0500000US48039,"Brazoria County, Texas",357781,217981,42202,57858,260183
690,0500000US48041,"Brazos County, Texas",211145,144238,20661,73351,164899
691,0500000US48061,"Cameron County, Texas",420857,236201,57102,184177,293303
692,0500000US48085,"Collin County, Texas",997405,630743,109159,118650,739902
693,0500000US48091,"Comal County, Texas",147197,87875,26134,20496,114009
694,0500000US48099,"Coryell County, Texas",59427,35572,6807,17395,42379
695,0500000US48113,"Dallas County, Texas",2606979,1647402,277275,645549,1924677
696,0500000US48121,"Denton County, Texas",847555,552261,85647,107142,637908
697,0500000US48135,"Ector County, Texas",160001,97019,14870,33022,111889
698,0500000US48139,"Ellis County, Texas",177669,107965,22257,31208,130222
699,0500000US48141,"El Paso County, Texas",823311,497977,101265,289974,599242
700,0500000US48157,"Fort Bend County, Texas",781373,481138,86468,103008,567606
701,0500000US48167,"Galveston County, Texas",330816,202758,47223,60673,249981
702,0500000US48181,"Grayson County, Texas",131708,77765,22870,25587,100635
703,0500000US48183,"Gregg County, Texas",119545,70627,18116,28388,88743
704,0500000US48187,"Guadalupe County, Texas",162000,99519,21584,25199,121103
705,0500000US48201,"Harris County, Texas",4650812,2924003,488101,1261060,3412104
706,0500000US48203,"Harrison County, Texas",65409,38088,10548,18073,48636
707,0500000US48209,"Hays County, Texas",216347,142342,24576,48495,166918
708,0500000US48213,"Henderson County, Texas",80972,45560,17737,26629,63297
709,0500000US48215,"Hidalgo County, Texas",855885,481850,94360,389164,576210
710,0500000US48231,"Hunt County, Texas",93804,56452,14388,21189,70840
711,0500000US48245,"Jefferson County, Texas",238819,143121,35485,71127,178606
712,0500000US48251,"Johnson County, Texas",167517,101521,22959,28670,124480
713,0500000US48257,"Kaufman County, Texas",127283,77043,14541,25492,91584
714,0500000US48291,"Liberty County, Texas",77343,44222,10621,18099,54843
715,0500000US48303,"Lubbock County, Texas",294817,186394,36612,83096,223006
716,0500000US48309,"McLennan County, Texas",243500,146963,35464,80218,182427
717,0500000US48329,"Midland County, Texas",171088,103926,18012,25979,121938
718,0500000US48339,"Montgomery County, Texas",587586,355729,77241,104315,432970
719,0500000US48347,"Nacogdoches County, Texas",60163,36070,9065,20859,45135
720,0500000US48355,"Nueces County, Texas",354405,214908,51361,92343,266269
721,0500000US48361,"Orange County, Texas",82529,48957,13128,14909,62085
722,0500000US48367,"Parker County, Texas",136635,81705,20749,20042,102454
723,0500000US48375,"Potter County, Texas",112439,67467,12675,41119,80142
724,0500000US48381,"Randall County, Texas",133515,81251,20448,15177,101699
725,0500000US48397,"Rockwall County, Texas",99787,60930,11835,6427,72765
726,0500000US48409,"San Patricio County, Texas",65952,38567,9814,19214,48381
727,0500000US48423,"Smith County, Texas",225242,132537,36791,51892,169328
728,0500000US48439,"Tarrant County, Texas",2059740,1285493,230166,438669,1515659
729,0500000US48441,"Taylor County, Texas",131275,79249,18731,37388,97980
730,0500000US48451,"Tom Green County, Texas",111904,66378,17551,28621,83929
731,0500000US48453,"Travis County, Texas",1223047,835352,121095,230870,956447
732,0500000US48469,"Victoria County, Texas",90649,53083,14413,23888,67496
733,0500000US48471,"Walker County, Texas",53233,34191,8411,20741,42602
734,0500000US48479,"Webb County, Texas",271899,156636,25656,107351,182292
735,0500000US48485,"Wichita County, Texas",118105,71064,17878,34455,88942
736,0500000US48491,"Williamson County, Texas",562076,350883,67789,69327,418672
737,0500000US48497,"Wise County, Texas",67384,40852,9838,9686,50690
738,0500000US49005,"Cache County, Utah",123727,74248,11318,32421,85566
739,0500000US49011,"Davis County, Utah",348731,201426,35294,35677,236720
740,0500000US49035,"Salt Lake County, Utah",1136737,706180,123471,179975,829651
741,0500000US49045,"Tooele County, Utah",69323,40362,6359,8384,46721
742,0500000US49049,"Utah County, Utah",607694,354523,47484,99742,402007
743,0500000US49053,"Washington County, Utah",169577,88502,37101,34985,125603
744,0500000US49057,"Weber County, Utah",252723,152504,29149,44850,181653
745,0500000US50007,"Chittenden County, Vermont",155033,100857,25395,24001,126252
746,0500000US51003,"Albemarle County, Virginia",100258,58436,20535,15095,78971
747,0500000US51013,"Arlington County, Virginia",233823,166899,24330,25774,191229
748,0500000US51015,"Augusta County, Virginia",70617,40574,15720,12513,56294
749,0500000US51019,"Bedford County, Virginia",78053,46207,16389,13885,62596
750,0500000US51041,"Chesterfield County, Virginia",344691,211373,51644,45915,263017
751,0500000US51059,"Fairfax County, Virginia",1140460,720918,153138,113804,874056
752,0500000US51061,"Fauquier County, Virginia",70079,42056,11728,7440,53784
753,0500000US51069,"Frederick County, Virginia",86853,51814,15035,9311,66849
754,0500000US51085,"Hanover County, Virginia",105381,63205,18676,8758,81881
755,0500000US51087,"Henrico County, Virginia",326230,202175,50414,49473,252589
756,0500000US51095,"James City County, Virginia",75450,40611,19342,9714,59953
757,0500000US51107,"Loudoun County, Virginia",403842,253505,37347,31020,290852
758,0500000US51121,"Montgomery County, Virginia",89387,63759,11868,29900,75627
759,0500000US51153,"Prince William County, Virginia",463244,291054,45989,55075,337043
760,0500000US51161,"Roanoke County, Virginia",91839,53834,19256,11555,73090
761,0500000US51165,"Rockingham County, Virginia",79468,46813,15059,14301,61872
762,0500000US51177,"Spotsylvania County, Virginia",133748,81839,18964,18121,100803
763,0500000US51179,"Stafford County, Virginia",146614,92233,15204,11780,107437
764,0500000US51199,"York County, Virginia",66329,38750,11423,7162,50173
765,0500000US51510,"Alexandria city, Virginia",159340,110689,19367,25670,130056
766,0500000US51550,"Chesapeake city, Virginia",235940,146876,31649,36983,178525
767,0500000US51650,"Hampton city, Virginia",129333,82260,20364,27476,102624
768,0500000US51680,"Lynchburg city, Virginia",71960,45092,11088,22756,56180
769,0500000US51700,"Newport News city, Virginia",169671,106445,22689,41683,129134
770,0500000US51710,"Norfolk city, Virginia",217816,143837,26700,58872,170537
771,0500000US51740,"Portsmouth city, Virginia",90192,55589,13654,26417,69243
772,0500000US51760,"Richmond city, Virginia",219006,150576,29751,64645,180327
773,0500000US51770,"Roanoke city, Virginia",98426,60301,16037,30478,76338
774,0500000US51800,"Suffolk city, Virginia",90460,55873,12889,13407,68762
775,0500000US51810,"Virginia Beach city, Virginia",439051,278290,63287,47967,341577
776,0500000US53005,"Benton County, Washington",200141,117082,29770,36315,146852
777,0500000US53007,"Chelan County, Washington",76201,44229,14090,14440,58319
778,0500000US53009,"Clallam County, Washington",75740,40941,21843,15612,62784
779,0500000US53011,"Clark County, Washington",476500,290797,73793,70782,364590
780,0500000US53015,"Cowlitz County, Washington",107503,62246,20423,22688,82669
781,0500000US53021,"Franklin County, Washington",91007,52432,8973,23981,61405
782,0500000US53025,"Grant County, Washington",96465,54651,13818,24933,68469
783,0500000US53027,"Grays Harbor County, Washington",70822,39910,15947,20317,55857
784,0500000US53029,"Island County, Washington",82552,47199,20669,11066,67868
785,0500000US53033,"King County, Washington",2201821,1465501,288876,294896,1754377
786,0500000US53035,"Kitsap County, Washington",261589,161318,46981,34077,208299
787,0500000US53041,"Lewis County, Washington",78661,45689,16305,17392,61994
788,0500000US53045,"Mason County, Washington",64467,37298,14636,14970,51934
789,0500000US53053,"Pierce County, Washington",875951,548496,120793,130472,669289
790,0500000US53057,"Skagit County, Washington",126446,72982,26291,18091,99273
791,0500000US53061,"Snohomish County, Washington",802700,513830,108036,96515,621866
792,0500000US53063,"Spokane County, Washington",500186,306982,81660,110805,388642
793,0500000US53067,"Thurston County, Washington",283280,173906,48545,44713,222451
794,0500000US53073,"Whatcom County, Washington",221147,138488,38703,48854,177191
795,0500000US53077,"Yakima County, Washington",247591,140681,33674,80673,174355
796,0500000US54003,"Berkeley County, West Virginia",116337,72146,17498,20864,89644
797,0500000US54011,"Cabell County, West Virginia",89106,54705,16494,28796,71199
798,0500000US54033,"Harrison County, West Virginia",65572,39963,12672,18859,52635
799,0500000US54039,"Kanawha County, West Virginia",176605,105628,36951,47861,142579
800,0500000US54061,"Monongalia County, West Virginia",100655,70707,12762,27157,83469
801,0500000US54081,"Raleigh County, West Virginia",71575,40644,15366,22760,56010
802,0500000US54107,"Wood County, West Virginia",83167,48785,16834,23936,65619
803,0500000US55009,"Brown County, Wisconsin",255746,155815,38666,40991,194481
804,0500000US55025,"Dane County, Wisconsin",529465,345077,74084,84916,419161
805,0500000US55027,"Dodge County, Wisconsin",83746,51845,14781,14055,66626
806,0500000US55035,"Eau Claire County, Wisconsin",100959,63868,16504,18525,80372
807,0500000US55039,"Fond du Lac County, Wisconsin",99714,59526,18503,15733,78029
808,0500000US55055,"Jefferson County, Wisconsin",82314,49830,14480,11507,64310
809,0500000US55059,"Kenosha County, Wisconsin",164954,104164,23004,30743,127168
810,0500000US55063,"La Crosse County, Wisconsin",113094,71928,18434,20055,90362
811,0500000US55071,"Manitowoc County, Wisconsin",77855,46965,15598,15293,62563
812,0500000US55073,"Marathon County, Wisconsin",133011,80338,23145,19136,103483
813,0500000US55079,"Milwaukee County, Wisconsin",926620,576953,125723,267911,702676
814,0500000US55087,"Outagamie County, Wisconsin",184316,113714,26930,22680,140644
815,0500000US55089,"Ozaukee County, Wisconsin",86875,50780,17418,7832,68198
816,0500000US55097,"Portage County, Wisconsin",67915,42482,11595,13136,54077
817,0500000US55101,"Racine County, Wisconsin",190105,115086,31024,41034,146110
818,0500000US55105,"Rock County, Wisconsin",158918,96872,26391,30632,123263
819,0500000US55109,"St. Croix County, Wisconsin",88903,54499,12061,7088,66560
820,0500000US55117,"Sheboygan County, Wisconsin",112476,67196,20277,15189,87473
821,0500000US55127,"Walworth County, Wisconsin",100900,62337,17677,19425,80014
822,0500000US55131,"Washington County, Wisconsin",135033,81480,23804,11474,105284
823,0500000US55133,"Waukesha County, Wisconsin",397531,238646,73947,33536,312593
824,0500000US55139,"Winnebago County, Wisconsin",162762,101692,27320,29293,129012
825,0500000US55141,"Wood County, Wisconsin",72025,42242,14637,15025,56879
826,0500000US56021,"Laramie County, Wyoming",96907,58329,15839,16216,74168
827,0500000US56025,"Natrona County, Wyoming",77033,47301,11526,9991,58827
828,0500000US72013,"Arecibo Municipio, Puerto Rico",81497,48832,17928,52735,66760
829,0500000US72021,"Bayamón Municipio, Puerto Rico",166308,100226,36575,85742,136801
830,0500000US72025,"Caguas Municipio, Puerto Rico",123252,75741,25251,60230,100992
831,0500000US72031,"Carolina Municipio, Puerto Rico",146998,87823,32985,74203,120808
832,0500000US72061,"Guaynabo Municipio, Puerto Rico",83413,51610,18607,32782,70217
833,0500000US72097,"Mayagüez Municipio, Puerto Rico",71123,41782,17252,49012,59034
834,0500000US72113,"Ponce Municipio, Puerto Rico",130211,75783,28976,86360,104759
835,0500000US72127,"San Juan Municipio, Puerto Rico",315765,189089,71282,163973,260371
836,0500000US72135,"Toa Alta Municipio, Puerto Rico",70861,46676,10228,34310,56904
837,0500000US72137,"Toa Baja Municipio, Puerto Rico",74137,45768,14662,40043,60430
838,0500000US72139,"Trujillo Alto Municipio, Puerto Rico",63407,39247,12207,27254,51454
